,Numéro,Inscrits,Votants,Nuls,Exprimes,Abstentions,Type election,Annee,Type enregistrement,Numéro tour,Code departement,Code commune,Indicatif,Votants emargement,Blancs,Nombre de listes,Liste,Bord politique,Voies
0,28,1074,561,7,554,513,MN,2014,V,1,31,555,I,561,0,10,Le rassemblement citoyen,A remplir,18
1,41,975,548,11,537,427,MN,2014,V,1,31,555,I,548,0,10,Le rassemblement citoyen,A remplir,14
2,72,1046,510,5,505,536,MN,2014,V,1,31,555,I,510,0,10,Le rassemblement citoyen,A remplir,14
3,105,961,472,16,456,489,MN,2014,V,1,31,555,I,472,0,10,Le rassemblement citoyen,A remplir,5
4,109,1098,619,15,604,479,MN,2014,V,1,31,555,I,619,0,10,Le rassemblement citoyen,A remplir,12
5,117,1119,551,9,542,568,MN,2014,V,1,31,555,I,551,0,10,Le rassemblement citoyen,A remplir,10
6,121,1065,621,6,615,444,MN,2014,V,1,31,555,I,621,0,10,Le rassemblement citoyen,A remplir,12
7,171,1072,450,13,437,622,MN,2014,V,1,31,555,I,450,0,10,Le rassemblement citoyen,A remplir,7
8,174A,1093,484,9,475,609,MN,2014,V,1,31,555,I,484,0,10,Le rassemblement citoyen,A remplir,17
9,192,698,315,9,306,383,MN,2014,V,1,31,555,I,315,0,10,Le rassemblement citoyen,A remplir,4
10,194,863,405,15,390,458,MN,2014,V,1,31,555,I,405,0,10,Le rassemblement citoyen,A remplir,13
11,214,1312,659,16,643,653,MN,2014,V,1,31,555,I,659,0,10,Le rassemblement citoyen,A remplir,23
12,3,919,501,10,491,418,MN,2014,V,1,31,555,I,501,0,10,Le rassemblement citoyen,A remplir,7
13,44A,1061,529,19,510,532,MN,2014,V,1,31,555,I,529,0,10,Le rassemblement citoyen,A remplir,10
14,47,1034,588,11,577,446,MN,2014,V,1,31,555,I,588,0,10,Le rassemblement citoyen,A remplir,16
15,62,1049,498,12,486,551,MN,2014,V,1,31,555,I,498,0,10,Le rassemblement citoyen,A remplir,8
16,82,976,490,12,478,486,MN,2014,V,1,31,555,I,490,0,10,Le rassemblement citoyen,A remplir,16
17,86,1070,542,8,534,528,MN,2014,V,1,31,555,I,542,0,10,Le rassemblement citoyen,A remplir,19
18,127,908,537,9,528,371,MN,2014,V,1,31,555,I,537,0,10,Le rassemblement citoyen,A remplir,9
19,156,889,425,11,414,464,MN,2014,V,1,31,555,I,425,0,10,Le rassemblement citoyen,A remplir,7
20,159,1232,667,12,655,565,MN,2014,V,1,31,555,I,667,0,10,Le rassemblement citoyen,A remplir,12
21,169,953,362,11,351,591,MN,2014,V,1,31,555,I,362,0,10,Le rassemblement citoyen,A remplir,4
22,173,962,388,8,380,574,MN,2014,V,1,31,555,I,388,0,10,Le rassemblement citoyen,A remplir,11
23,203,848,421,16,405,427,MN,2014,V,1,31,555,I,421,0,10,Le rassemblement citoyen,A remplir,11
24,203B,1049,585,16,569,464,MN,2014,V,1,31,555,I,585,0,10,Le rassemblement citoyen,A remplir,11
25,18,1208,703,23,680,505,MN,2014,V,1,31,555,I,703,0,10,Le rassemblement citoyen,A remplir,10
26,48,1004,509,11,498,495,MN,2014,V,1,31,555,I,509,0,10,Le rassemblement citoyen,A remplir,12
27,57,882,517,18,499,365,MN,2014,V,1,31,555,I,517,0,10,Le rassemblement citoyen,A remplir,11
28,68,1002,582,23,559,420,MN,2014,V,1,31,555,I,582,0,10,Le rassemblement citoyen,A remplir,11
29,128,1114,576,22,554,538,MN,2014,V,1,31,555,I,576,0,10,Le rassemblement citoyen,A remplir,26
30,137,995,617,10,607,378,MN,2014,V,1,31,555,I,617,0,10,Le rassemblement citoyen,A remplir,10
31,144A,992,563,13,551,429,MN,2014,V,1,31,555,I,563,0,10,Le rassemblement citoyen,A remplir,10
32,157,1208,645,11,634,563,MN,2014,V,1,31,555,I,645,0,10,Le rassemblement citoyen,A remplir,15
33,166,1147,666,12,653,481,MN,2014,V,1,31,555,I,666,0,10,Le rassemblement citoyen,A remplir,21
34,195,811,443,7,436,368,MN,2014,V,1,31,555,I,443,0,10,Le rassemblement citoyen,A remplir,11
35,200A,1064,537,13,524,527,MN,2014,V,1,31,555,I,537,0,10,Le rassemblement citoyen,A remplir,17
36,203A,817,451,6,445,366,MN,2014,V,1,31,555,I,451,0,10,Le rassemblement citoyen,A remplir,14
37,35,1057,526,10,516,531,MN,2014,V,1,31,555,I,526,0,10,Le rassemblement citoyen,A remplir,12
38,45,1038,429,8,421,609,MN,2014,V,1,31,555,I,429,0,10,Le rassemblement citoyen,A remplir,12
39,61,859,467,16,451,392,MN,2014,V,1,31,555,I,467,0,10,Le rassemblement citoyen,A remplir,18
40,94,1110,641,11,630,469,MN,2014,V,1,31,555,I,641,0,10,Le rassemblement citoyen,A remplir,28
41,107,1019,581,8,573,438,MN,2014,V,1,31,555,I,581,0,10,Le rassemblement citoyen,A remplir,5
42,110,918,502,13,489,416,MN,2014,V,1,31,555,I,502,0,10,Le rassemblement citoyen,A remplir,12
43,134A,1406,745,22,723,661,MN,2014,V,1,31,555,I,745,0,10,Le rassemblement citoyen,A remplir,14
44,146,833,440,3,437,393,MN,2014,V,1,31,555,I,440,0,10,Le rassemblement citoyen,A remplir,10
45,186,1299,322,18,304,977,MN,2014,V,1,31,555,I,322,0,10,Le rassemblement citoyen,A remplir,5
46,195A,1090,474,13,461,616,MN,2014,V,1,31,555,I,474,0,10,Le rassemblement citoyen,A remplir,6
47,16,947,558,10,548,389,MN,2014,V,1,31,555,I,558,0,10,Le rassemblement citoyen,A remplir,16
48,39A,938,525,28,497,413,MN,2014,V,1,31,555,I,525,0,10,Le rassemblement citoyen,A remplir,19
49,85,994,452,13,439,542,MN,2014,V,1,31,555,I,452,0,10,Le rassemblement citoyen,A remplir,8
50,87,1204,619,8,612,585,MN,2014,V,1,31,555,I,619,0,10,Le rassemblement citoyen,A remplir,16
51,93B,1235,656,16,640,579,MN,2014,V,1,31,555,I,656,0,10,Le rassemblement citoyen,A remplir,16
52,101,1126,627,10,617,499,MN,2014,V,1,31,555,I,627,0,10,Le rassemblement citoyen,A remplir,17
53,104,1042,609,21,588,433,MN,2014,V,1,31,555,I,609,0,10,Le rassemblement citoyen,A remplir,18
54,112,841,429,10,419,412,MN,2014,V,1,31,555,I,429,0,10,Le rassemblement citoyen,A remplir,14
55,148,830,418,14,404,412,MN,2014,V,1,31,555,I,418,0,10,Le rassemblement citoyen,A remplir,9
56,207,1141,602,18,584,539,MN,2014,V,1,31,555,I,602,0,10,Le rassemblement citoyen,A remplir,15
57,210,1252,597,16,581,655,MN,2014,V,1,31,555,I,597,0,10,Le rassemblement citoyen,A remplir,7
58,10,979,521,13,508,458,MN,2014,V,1,31,555,I,521,0,10,Le rassemblement citoyen,A remplir,14
59,77,976,544,9,535,432,MN,2014,V,1,31,555,I,544,0,10,Le rassemblement citoyen,A remplir,20
60,91,1000,523,15,508,477,MN,2014,V,1,31,555,I,523,0,10,Le rassemblement citoyen,A remplir,12
61,132,1073,553,5,548,520,MN,2014,V,1,31,555,I,553,0,10,Le rassemblement citoyen,A remplir,13
62,189,832,311,8,303,521,MN,2014,V,1,31,555,I,311,0,10,Le rassemblement citoyen,A remplir,5
63,193A,795,360,9,351,435,MN,2014,V,1,31,555,I,360,0,10,Le rassemblement citoyen,A remplir,5
64,209,1102,507,22,485,595,MN,2014,V,1,31,555,I,507,0,10,Le rassemblement citoyen,A remplir,17
65,212,442,187,4,183,255,MN,2014,V,1,31,555,I,187,0,10,Le rassemblement citoyen,A remplir,3
66,4,956,571,10,561,385,MN,2014,V,1,31,555,I,571,0,10,Le rassemblement citoyen,A remplir,5
67,19,1084,637,8,631,447,MN,2014,V,1,31,555,I,637,0,10,Le rassemblement citoyen,A remplir,19
68,30,992,554,7,547,438,MN,2014,V,1,31,555,I,554,0,10,Le rassemblement citoyen,A remplir,7
69,56,1025,487,8,479,538,MN,2014,V,1,31,555,I,487,0,10,Le rassemblement citoyen,A remplir,9
70,84,1173,642,7,635,531,MN,2014,V,1,31,555,I,642,0,10,Le rassemblement citoyen,A remplir,11
71,93A,1276,661,14,647,615,MN,2014,V,1,31,555,I,661,0,10,Le rassemblement citoyen,A remplir,20
72,144,991,611,13,598,380,MN,2014,V,1,31,555,I,611,0,10,Le rassemblement citoyen,A remplir,17
73,22,1086,605,16,589,481,MN,2014,V,1,31,555,I,605,0,10,Le rassemblement citoyen,A remplir,14
74,25,1083,547,7,540,536,MN,2014,V,1,31,555,I,547,0,10,Le rassemblement citoyen,A remplir,21
75,73,1069,531,13,518,538,MN,2014,V,1,31,555,I,531,0,10,Le rassemblement citoyen,A remplir,23
76,99,933,486,11,475,447,MN,2014,V,1,31,555,I,486,0,10,Le rassemblement citoyen,A remplir,11
77,103,871,459,18,441,412,MN,2014,V,1,31,555,I,459,0,10,Le rassemblement citoyen,A remplir,7
78,140,935,559,9,550,376,MN,2014,V,1,31,555,I,559,0,10,Le rassemblement citoyen,A remplir,9
79,150,1022,574,6,568,448,MN,2014,V,1,31,555,I,574,0,10,Le rassemblement citoyen,A remplir,25
80,168,934,464,17,447,470,MN,2014,V,1,31,555,I,464,0,10,Le rassemblement citoyen,A remplir,6
81,22A,1047,587,16,571,460,MN,2014,V,1,31,555,I,587,0,10,Le rassemblement citoyen,A remplir,15
82,52,1066,539,12,527,527,MN,2014,V,1,31,555,I,539,0,10,Le rassemblement citoyen,A remplir,13
83,66,862,474,16,458,388,MN,2014,V,1,31,555,I,474,0,10,Le rassemblement citoyen,A remplir,11
84,96,978,542,17,525,436,MN,2014,V,1,31,555,I,542,0,10,Le rassemblement citoyen,A remplir,9
85,118,1142,631,12,619,511,MN,2014,V,1,31,555,I,631,0,10,Le rassemblement citoyen,A remplir,14
86,139,965,529,11,518,436,MN,2014,V,1,31,555,I,529,0,10,Le rassemblement citoyen,A remplir,12
87,141,957,569,8,561,388,MN,2014,V,1,31,555,I,569,0,10,Le rassemblement citoyen,A remplir,13
88,164,1183,491,16,475,692,MN,2014,V,1,31,555,I,491,0,10,Le rassemblement citoyen,A remplir,17
89,181,931,370,12,358,561,MN,2014,V,1,31,555,I,370,0,10,Le rassemblement citoyen,A remplir,3
90,211A,1286,623,28,595,663,MN,2014,V,1,31,555,I,623,0,10,Le rassemblement citoyen,A remplir,15
91,2,931,505,12,493,426,MN,2014,V,1,31,555,I,505,0,10,Le rassemblement citoyen,A remplir,12
92,9,941,528,3,525,413,MN,2014,V,1,31,555,I,528,0,10,Le rassemblement citoyen,A remplir,19
93,40,1276,595,11,584,681,MN,2014,V,1,31,555,I,595,0,10,Le rassemblement citoyen,A remplir,11
94,59,1038,581,10,571,457,MN,2014,V,1,31,555,I,581,0,10,Le rassemblement citoyen,A remplir,10
95,88,1122,596,12,584,526,MN,2014,V,1,31,555,I,596,0,10,Le rassemblement citoyen,A remplir,20
96,106,962,481,17,465,481,MN,2014,V,1,31,555,I,481,0,10,Le rassemblement citoyen,A remplir,16
97,120,1058,610,18,592,448,MN,2014,V,1,31,555,I,610,0,10,Le rassemblement citoyen,A remplir,10
98,145,1015,549,14,535,466,MN,2014,V,1,31,555,I,549,0,10,Le rassemblement citoyen,A remplir,10
99,149,1123,622,12,610,501,MN,2014,V,1,31,555,I,622,0,10,Le rassemblement citoyen,A remplir,13
100,201B,1032,580,19,561,452,MN,2014,V,1,31,555,I,580,0,10,Le rassemblement citoyen,A remplir,10
101,206,1087,549,20,529,538,MN,2014,V,1,31,555,I,549,0,10,Le rassemblement citoyen,A remplir,4
102,55,1082,614,14,600,468,MN,2014,V,1,31,555,I,614,0,10,Le rassemblement citoyen,A remplir,23
103,83,1176,712,10,702,464,MN,2014,V,1,31,555,I,712,0,10,Le rassemblement citoyen,A remplir,11
104,136,730,449,8,442,281,MN,2014,V,1,31,555,I,449,0,10,Le rassemblement citoyen,A remplir,14
105,158,1155,634,10,624,521,MN,2014,V,1,31,555,I,634,0,10,Le rassemblement citoyen,A remplir,25
106,162,1033,534,12,522,499,MN,2014,V,1,31,555,I,534,0,10,Le rassemblement citoyen,A remplir,16
107,170,819,446,8,438,373,MN,2014,V,1,31,555,I,446,0,10,Le rassemblement citoyen,A remplir,8
108,172,870,533,11,522,337,MN,2014,V,1,31,555,I,533,0,10,Le rassemblement citoyen,A remplir,8
109,222,1321,665,21,644,656,MN,2014,V,1,31,555,I,665,0,10,Le rassemblement citoyen,A remplir,12
110,7,928,450,9,441,478,MN,2014,V,1,31,555,I,450,0,10,Le rassemblement citoyen,A remplir,12
111,11,1115,633,14,620,482,MN,2014,V,1,31,555,I,633,0,10,Le rassemblement citoyen,A remplir,19
112,21,944,561,12,549,383,MN,2014,V,1,31,555,I,561,0,10,Le rassemblement citoyen,A remplir,17
113,53,1067,569,13,556,498,MN,2014,V,1,31,555,I,569,0,10,Le rassemblement citoyen,A remplir,10
114,122,1038,637,5,632,401,MN,2014,V,1,31,555,I,637,0,10,Le rassemblement citoyen,A remplir,18
115,124,1082,650,16,634,432,MN,2014,V,1,31,555,I,650,0,10,Le rassemblement citoyen,A remplir,10
116,129,990,483,16,467,507,MN,2014,V,1,31,555,I,483,0,10,Le rassemblement citoyen,A remplir,10
117,134,875,516,10,506,359,MN,2014,V,1,31,555,I,516,0,10,Le rassemblement citoyen,A remplir,11
118,135,1027,636,7,630,391,MN,2014,V,1,31,555,I,636,0,10,Le rassemblement citoyen,A remplir,13
119,175,995,320,11,309,675,MN,2014,V,1,31,555,I,320,0,10,Le rassemblement citoyen,A remplir,4
120,177,1084,439,24,415,645,MN,2014,V,1,31,555,I,439,0,10,Le rassemblement citoyen,A remplir,4
121,193,650,268,4,264,382,MN,2014,V,1,31,555,I,268,0,10,Le rassemblement citoyen,A remplir,2
122,199,503,252,4,248,251,MN,2014,V,1,31,555,I,252,0,10,Le rassemblement citoyen,A remplir,4
123,213,1101,583,17,566,518,MN,2014,V,1,31,555,I,583,0,10,Le rassemblement citoyen,A remplir,17
124,219,1138,614,10,604,524,MN,2014,V,1,31,555,I,614,0,10,Le rassemblement citoyen,A remplir,18
125,12,1116,608,12,596,508,MN,2014,V,1,31,555,I,608,0,10,Le rassemblement citoyen,A remplir,10
126,31,1020,561,8,553,459,MN,2014,V,1,31,555,I,561,0,10,Le rassemblement citoyen,A remplir,12
127,36,806,435,14,421,371,MN,2014,V,1,31,555,I,435,0,10,Le rassemblement citoyen,A remplir,10
128,46,986,558,11,547,428,MN,2014,V,1,31,555,I,558,0,10,Le rassemblement citoyen,A remplir,26
129,81,1177,499,16,483,678,MN,2014,V,1,31,555,I,499,0,10,Le rassemblement citoyen,A remplir,12
130,142,890,459,6,453,431,MN,2014,V,1,31,555,I,459,0,10,Le rassemblement citoyen,A remplir,9
131,152,944,355,14,341,589,MN,2014,V,1,31,555,I,355,0,10,Le rassemblement citoyen,A remplir,2
132,167,995,543,9,534,452,MN,2014,V,1,31,555,I,543,0,10,Le rassemblement citoyen,A remplir,15
133,190,1008,247,9,238,761,MN,2014,V,1,31,555,I,247,0,10,Le rassemblement citoyen,A remplir,5
134,225,838,451,16,435,387,MN,2014,V,1,31,555,I,451,0,10,Le rassemblement citoyen,A remplir,5
135,49,759,440,8,432,319,MN,2014,V,1,31,555,I,440,0,10,Le rassemblement citoyen,A remplir,20
136,50,977,533,16,517,444,MN,2014,V,1,31,555,I,533,0,10,Le rassemblement citoyen,A remplir,19
137,60,1164,611,25,586,553,MN,2014,V,1,31,555,I,611,0,10,Le rassemblement citoyen,A remplir,13
138,108A,939,523,13,510,416,MN,2014,V,1,31,555,I,523,0,10,Le rassemblement citoyen,A remplir,12
139,125,957,575,11,564,382,MN,2014,V,1,31,555,I,575,0,10,Le rassemblement citoyen,A remplir,20
140,182,794,435,10,425,359,MN,2014,V,1,31,555,I,435,0,10,Le rassemblement citoyen,A remplir,12
141,215,1373,629,18,611,744,MN,2014,V,1,31,555,I,629,0,10,Le rassemblement citoyen,A remplir,11
142,1,1100,541,10,532,559,MN,2014,V,1,31,555,I,541,0,10,Le rassemblement citoyen,A remplir,8
143,44,971,558,16,542,413,MN,2014,V,1,31,555,I,558,0,10,Le rassemblement citoyen,A remplir,18
144,49A,856,513,8,505,343,MN,2014,V,1,31,555,I,513,0,10,Le rassemblement citoyen,A remplir,14
145,165A,982,609,11,598,373,MN,2014,V,1,31,555,I,609,0,10,Le rassemblement citoyen,A remplir,12
146,200,1192,654,15,639,538,MN,2014,V,1,31,555,I,654,0,10,Le rassemblement citoyen,A remplir,7
147,5,772,439,10,429,333,MN,2014,V,1,31,555,I,439,0,10,Le rassemblement citoyen,A remplir,1
148,24,1061,543,8,535,518,MN,2014,V,1,31,555,I,543,0,10,Le rassemblement citoyen,A remplir,11
149,25A,1002,518,11,507,484,MN,2014,V,1,31,555,I,518,0,10,Le rassemblement citoyen,A remplir,12
150,51,1230,659,18,641,571,MN,2014,V,1,31,555,I,659,0,10,Le rassemblement citoyen,A remplir,22
151,71,941,513,10,504,428,MN,2014,V,1,31,555,I,513,0,10,Le rassemblement citoyen,A remplir,9
152,78,1006,624,19,605,382,MN,2014,V,1,31,555,I,624,0,10,Le rassemblement citoyen,A remplir,13
153,79,915,498,6,491,417,MN,2014,V,1,31,555,I,498,0,10,Le rassemblement citoyen,A remplir,11
154,80,1173,553,9,544,620,MN,2014,V,1,31,555,I,553,0,10,Le rassemblement citoyen,A remplir,9
155,97,1084,564,10,553,520,MN,2014,V,1,31,555,I,564,0,10,Le rassemblement citoyen,A remplir,17
156,184,1151,355,10,345,796,MN,2014,V,1,31,555,I,355,0,10,Le rassemblement citoyen,A remplir,13
157,188,1220,497,20,477,723,MN,2014,V,1,31,555,I,497,0,10,Le rassemblement citoyen,A remplir,7
158,8,891,480,13,467,411,MN,2014,V,1,31,555,I,480,0,10,Le rassemblement citoyen,A remplir,11
159,14,1014,595,6,589,419,MN,2014,V,1,31,555,I,595,0,10,Le rassemblement citoyen,A remplir,8
160,34,953,496,10,486,457,MN,2014,V,1,31,555,I,496,0,10,Le rassemblement citoyen,A remplir,9
161,39,1160,603,12,591,557,MN,2014,V,1,31,555,I,603,0,10,Le rassemblement citoyen,A remplir,5
162,63,806,314,6,308,492,MN,2014,V,1,31,555,I,314,0,10,Le rassemblement citoyen,A remplir,5
163,124A,982,582,15,567,400,MN,2014,V,1,31,555,I,582,0,10,Le rassemblement citoyen,A remplir,8
164,205,1184,651,18,633,533,MN,2014,V,1,31,555,I,651,0,10,Le rassemblement citoyen,A remplir,16
165,6,1098,531,11,520,567,MN,2014,V,1,31,555,I,531,0,10,Le rassemblement citoyen,A remplir,10
166,23,1205,614,7,607,591,MN,2014,V,1,31,555,I,614,0,10,Le rassemblement citoyen,A remplir,20
167,64,1233,675,22,653,558,MN,2014,V,1,31,555,I,675,0,10,Le rassemblement citoyen,A remplir,19
168,75,949,456,15,441,493,MN,2014,V,1,31,555,I,456,0,10,Le rassemblement citoyen,A remplir,14
169,76,1007,517,7,510,490,MN,2014,V,1,31,555,I,517,0,10,Le rassemblement citoyen,A remplir,15
170,111,956,511,10,501,445,MN,2014,V,1,31,555,I,511,0,10,Le rassemblement citoyen,A remplir,11
171,123,1134,589,8,581,545,MN,2014,V,1,31,555,I,589,0,10,Le rassemblement citoyen,A remplir,19
172,131,1051,602,12,590,449,MN,2014,V,1,31,555,I,602,0,10,Le rassemblement citoyen,A remplir,8
173,154,809,278,13,265,531,MN,2014,V,1,31,555,I,278,0,10,Le rassemblement citoyen,A remplir,2
174,179,709,357,9,348,352,MN,2014,V,1,31,555,I,357,0,10,Le rassemblement citoyen,A remplir,11
175,211,1377,732,18,714,645,MN,2014,V,1,31,555,I,732,0,10,Le rassemblement citoyen,A remplir,22
176,13,1041,588,11,577,453,MN,2014,V,1,31,555,I,588,0,10,Le rassemblement citoyen,A remplir,29
177,15,1078,643,10,633,435,MN,2014,V,1,31,555,I,643,0,10,Le rassemblement citoyen,A remplir,30
178,27,1122,647,10,637,475,MN,2014,V,1,31,555,I,647,0,10,Le rassemblement citoyen,A remplir,9
179,36A,1124,605,14,591,519,MN,2014,V,1,31,555,I,605,0,10,Le rassemblement citoyen,A remplir,15
180,56A,894,469,9,460,425,MN,2014,V,1,31,555,I,469,0,10,Le rassemblement citoyen,A remplir,10
181,69,1090,574,12,562,516,MN,2014,V,1,31,555,I,574,0,10,Le rassemblement citoyen,A remplir,12
182,113,1030,455,18,437,575,MN,2014,V,1,31,555,I,455,0,10,Le rassemblement citoyen,A remplir,7
183,147,1006,591,11,580,415,MN,2014,V,1,31,555,I,591,0,10,Le rassemblement citoyen,A remplir,16
184,165,1463,797,24,773,666,MN,2014,V,1,31,555,I,797,0,10,Le rassemblement citoyen,A remplir,21
185,201A,1154,711,21,690,443,MN,2014,V,1,31,555,I,711,0,10,Le rassemblement citoyen,A remplir,14
186,204,1153,587,18,569,566,MN,2014,V,1,31,555,I,587,0,10,Le rassemblement citoyen,A remplir,19
187,218,1264,701,15,686,563,MN,2014,V,1,31,555,I,701,0,10,Le rassemblement citoyen,A remplir,11
188,220,1242,685,19,666,557,MN,2014,V,1,31,555,I,685,0,10,Le rassemblement citoyen,A remplir,10
189,42,962,516,14,502,446,MN,2014,V,1,31,555,I,516,0,10,Le rassemblement citoyen,A remplir,21
190,58,1199,536,13,523,663,MN,2014,V,1,31,555,I,536,0,10,Le rassemblement citoyen,A remplir,10
191,95,1039,530,11,519,509,MN,2014,V,1,31,555,I,530,0,10,Le rassemblement citoyen,A remplir,16
192,116,1060,541,13,528,519,MN,2014,V,1,31,555,I,541,0,10,Le rassemblement citoyen,A remplir,15
193,151,983,544,9,535,439,MN,2014,V,1,31,555,I,544,0,10,Le rassemblement citoyen,A remplir,15
194,155,726,257,7,250,469,MN,2014,V,1,31,555,I,257,0,10,Le rassemblement citoyen,A remplir,9
195,198B,1072,625,17,608,447,MN,2014,V,1,31,555,I,625,0,10,Le rassemblement citoyen,A remplir,21
196,201,1015,630,10,620,385,MN,2014,V,1,31,555,I,630,0,10,Le rassemblement citoyen,A remplir,15
197,224,780,412,11,401,368,MN,2014,V,1,31,555,I,412,0,10,Le rassemblement citoyen,A remplir,8
198,17,940,535,10,525,405,MN,2014,V,1,31,555,I,535,0,10,Le rassemblement citoyen,A remplir,11
199,65,1142,646,19,627,496,MN,2014,V,1,31,555,I,646,0,10,Le rassemblement citoyen,A remplir,18
200,67,983,550,21,529,433,MN,2014,V,1,31,555,I,550,0,10,Le rassemblement citoyen,A remplir,14
201,102,739,369,8,361,370,MN,2014,V,1,31,555,I,369,0,10,Le rassemblement citoyen,A remplir,6
202,113A,976,526,13,513,450,MN,2014,V,1,31,555,I,526,0,10,Le rassemblement citoyen,A remplir,10
203,119,970,576,9,567,394,MN,2014,V,1,31,555,I,576,0,10,Le rassemblement citoyen,A remplir,8
204,191A,925,327,20,307,598,MN,2014,V,1,31,555,I,327,0,10,Le rassemblement citoyen,A remplir,10
205,198,1241,700,19,681,541,MN,2014,V,1,31,555,I,700,0,10,Le rassemblement citoyen,A remplir,9
206,208,1196,696,27,669,500,MN,2014,V,1,31,555,I,696,0,10,Le rassemblement citoyen,A remplir,9
207,32,848,516,8,508,332,MN,2014,V,1,31,555,I,516,0,10,Le rassemblement citoyen,A remplir,6
208,33,1059,631,17,614,428,MN,2014,V,1,31,555,I,631,0,10,Le rassemblement citoyen,A remplir,13
209,44B,805,394,16,378,411,MN,2014,V,1,31,555,I,394,0,10,Le rassemblement citoyen,A remplir,8
210,54,991,513,15,497,478,MN,2014,V,1,31,555,I,513,0,10,Le rassemblement citoyen,A remplir,15
211,92,1184,581,19,562,603,MN,2014,V,1,31,555,I,581,0,10,Le rassemblement citoyen,A remplir,10
212,93,1248,671,22,649,577,MN,2014,V,1,31,555,I,671,0,10,Le rassemblement citoyen,A remplir,15
213,108,1029,598,16,582,431,MN,2014,V,1,31,555,I,598,0,10,Le rassemblement citoyen,A remplir,17
214,138,889,558,15,543,331,MN,2014,V,1,31,555,I,558,0,10,Le rassemblement citoyen,A remplir,6
215,153,706,148,5,143,558,MN,2014,V,1,31,555,I,148,0,10,Le rassemblement citoyen,A remplir,3
216,163,1016,466,7,460,550,MN,2014,V,1,31,555,I,466,0,10,Le rassemblement citoyen,A remplir,21
217,191,1000,255,12,243,745,MN,2014,V,1,31,555,I,255,0,10,Le rassemblement citoyen,A remplir,7
218,197,994,590,20,570,404,MN,2014,V,1,31,555,I,590,0,10,Le rassemblement citoyen,A remplir,26
219,198A,955,556,15,541,399,MN,2014,V,1,31,555,I,556,0,10,Le rassemblement citoyen,A remplir,14
220,223,1190,637,21,616,553,MN,2014,V,1,31,555,I,637,0,10,Le rassemblement citoyen,A remplir,21
221,226,987,505,6,499,482,MN,2014,V,1,31,555,I,505,0,10,Le rassemblement citoyen,A remplir,18
222,37,890,465,15,450,425,MN,2014,V,1,31,555,I,465,0,10,Le rassemblement citoyen,A remplir,14
223,70,1004,580,14,566,424,MN,2014,V,1,31,555,I,580,0,10,Le rassemblement citoyen,A remplir,11
224,74,1059,538,7,531,521,MN,2014,V,1,31,555,I,538,0,10,Le rassemblement citoyen,A remplir,4
225,178,970,371,10,361,599,MN,2014,V,1,31,555,I,371,0,10,Le rassemblement citoyen,A remplir,8
226,10A,1006,494,11,483,512,MN,2014,V,1,31,555,I,494,0,10,Le rassemblement citoyen,A remplir,9
227,29,1159,606,9,598,553,MN,2014,V,1,31,555,I,606,0,10,Le rassemblement citoyen,A remplir,19
228,67A,929,482,11,471,447,MN,2014,V,1,31,555,I,482,0,10,Le rassemblement citoyen,A remplir,11
229,100,1027,479,9,470,548,MN,2014,V,1,31,555,I,479,0,10,Le rassemblement citoyen,A remplir,22
230,114,1108,530,15,515,578,MN,2014,V,1,31,555,I,530,0,10,Le rassemblement citoyen,A remplir,7
231,126,911,511,9,502,400,MN,2014,V,1,31,555,I,511,0,10,Le rassemblement citoyen,A remplir,13
232,130,1083,574,13,561,509,MN,2014,V,1,31,555,I,574,0,10,Le rassemblement citoyen,A remplir,15
233,161,967,524,11,513,443,MN,2014,V,1,31,555,I,524,0,10,Le rassemblement citoyen,A remplir,21
234,174,1101,559,8,551,542,MN,2014,V,1,31,555,I,559,0,10,Le rassemblement citoyen,A remplir,17
235,202,1197,556,19,537,641,MN,2014,V,1,31,555,I,556,0,10,Le rassemblement citoyen,A remplir,13
236,216,1186,583,17,566,603,MN,2014,V,1,31,555,I,583,0,10,Le rassemblement citoyen,A remplir,13
237,216A,1122,459,20,439,663,MN,2014,V,1,31,555,I,459,0,10,Le rassemblement citoyen,A remplir,3
238,20,1041,656,16,640,385,MN,2014,V,1,31,555,I,656,0,10,Le rassemblement citoyen,A remplir,14
239,38,975,516,18,498,459,MN,2014,V,1,31,555,I,516,0,10,Le rassemblement citoyen,A remplir,17
240,43,1026,583,21,562,443,MN,2014,V,1,31,555,I,583,0,10,Le rassemblement citoyen,A remplir,9
241,133,983,556,15,541,427,MN,2014,V,1,31,555,I,556,0,10,Le rassemblement citoyen,A remplir,6
242,138A,951,606,17,589,345,MN,2014,V,1,31,555,I,606,0,10,Le rassemblement citoyen,A remplir,6
243,143,984,592,9,583,392,MN,2014,V,1,31,555,I,592,0,10,Le rassemblement citoyen,A remplir,7
244,160,1056,563,10,553,493,MN,2014,V,1,31,555,I,563,0,10,Le rassemblement citoyen,A remplir,14
245,180,755,275,2,273,480,MN,2014,V,1,31,555,I,275,0,10,Le rassemblement citoyen,A remplir,4
246,195B,1078,677,18,659,401,MN,2014,V,1,31,555,I,677,0,10,Le rassemblement citoyen,A remplir,18
247,196,1165,666,15,651,499,MN,2014,V,1,31,555,I,666,0,10,Le rassemblement citoyen,A remplir,25
248,217,1275,630,18,612,645,MN,2014,V,1,31,555,I,630,0,10,Le rassemblement citoyen,A remplir,12
249,28,1074,561,7,554,513,MN,2014,V,1,31,555,I,561,0,10,L'alternative responsable,A remplir,15
250,41,975,548,11,537,427,MN,2014,V,1,31,555,I,548,0,10,L'alternative responsable,A remplir,10
251,72,1046,510,5,505,536,MN,2014,V,1,31,555,I,510,0,10,L'alternative responsable,A remplir,22
252,105,961,472,16,456,489,MN,2014,V,1,31,555,I,472,0,10,L'alternative responsable,A remplir,5
253,109,1098,619,15,604,479,MN,2014,V,1,31,555,I,619,0,10,L'alternative responsable,A remplir,15
254,117,1119,551,9,542,568,MN,2014,V,1,31,555,I,551,0,10,L'alternative responsable,A remplir,6
255,121,1065,621,6,615,444,MN,2014,V,1,31,555,I,621,0,10,L'alternative responsable,A remplir,10
256,171,1072,450,13,437,622,MN,2014,V,1,31,555,I,450,0,10,L'alternative responsable,A remplir,3
257,174A,1093,484,9,475,609,MN,2014,V,1,31,555,I,484,0,10,L'alternative responsable,A remplir,11
258,192,698,315,9,306,383,MN,2014,V,1,31,555,I,315,0,10,L'alternative responsable,A remplir,4
259,194,863,405,15,390,458,MN,2014,V,1,31,555,I,405,0,10,L'alternative responsable,A remplir,8
260,214,1312,659,16,643,653,MN,2014,V,1,31,555,I,659,0,10,L'alternative responsable,A remplir,18
261,3,919,501,10,491,418,MN,2014,V,1,31,555,I,501,0,10,L'alternative responsable,A remplir,25
262,44A,1061,529,19,510,532,MN,2014,V,1,31,555,I,529,0,10,L'alternative responsable,A remplir,11
263,47,1034,588,11,577,446,MN,2014,V,1,31,555,I,588,0,10,L'alternative responsable,A remplir,14
264,62,1049,498,12,486,551,MN,2014,V,1,31,555,I,498,0,10,L'alternative responsable,A remplir,10
265,82,976,490,12,478,486,MN,2014,V,1,31,555,I,490,0,10,L'alternative responsable,A remplir,13
266,86,1070,542,8,534,528,MN,2014,V,1,31,555,I,542,0,10,L'alternative responsable,A remplir,25
267,127,908,537,9,528,371,MN,2014,V,1,31,555,I,537,0,10,L'alternative responsable,A remplir,12
268,156,889,425,11,414,464,MN,2014,V,1,31,555,I,425,0,10,L'alternative responsable,A remplir,11
269,159,1232,667,12,655,565,MN,2014,V,1,31,555,I,667,0,10,L'alternative responsable,A remplir,12
270,169,953,362,11,351,591,MN,2014,V,1,31,555,I,362,0,10,L'alternative responsable,A remplir,2
271,173,962,388,8,380,574,MN,2014,V,1,31,555,I,388,0,10,L'alternative responsable,A remplir,12
272,203,848,421,16,405,427,MN,2014,V,1,31,555,I,421,0,10,L'alternative responsable,A remplir,7
273,203B,1049,585,16,569,464,MN,2014,V,1,31,555,I,585,0,10,L'alternative responsable,A remplir,8
274,18,1208,703,23,680,505,MN,2014,V,1,31,555,I,703,0,10,L'alternative responsable,A remplir,16
275,48,1004,509,11,498,495,MN,2014,V,1,31,555,I,509,0,10,L'alternative responsable,A remplir,11
276,57,882,517,18,499,365,MN,2014,V,1,31,555,I,517,0,10,L'alternative responsable,A remplir,13
277,68,1002,582,23,559,420,MN,2014,V,1,31,555,I,582,0,10,L'alternative responsable,A remplir,8
278,128,1114,576,22,554,538,MN,2014,V,1,31,555,I,576,0,10,L'alternative responsable,A remplir,10
279,137,995,617,10,607,378,MN,2014,V,1,31,555,I,617,0,10,L'alternative responsable,A remplir,15
280,144A,992,563,13,551,429,MN,2014,V,1,31,555,I,563,0,10,L'alternative responsable,A remplir,10
281,157,1208,645,11,634,563,MN,2014,V,1,31,555,I,645,0,10,L'alternative responsable,A remplir,8
282,166,1147,666,12,653,481,MN,2014,V,1,31,555,I,666,0,10,L'alternative responsable,A remplir,13
283,195,811,443,7,436,368,MN,2014,V,1,31,555,I,443,0,10,L'alternative responsable,A remplir,8
284,200A,1064,537,13,524,527,MN,2014,V,1,31,555,I,537,0,10,L'alternative responsable,A remplir,16
285,203A,817,451,6,445,366,MN,2014,V,1,31,555,I,451,0,10,L'alternative responsable,A remplir,7
286,35,1057,526,10,516,531,MN,2014,V,1,31,555,I,526,0,10,L'alternative responsable,A remplir,17
287,45,1038,429,8,421,609,MN,2014,V,1,31,555,I,429,0,10,L'alternative responsable,A remplir,13
288,61,859,467,16,451,392,MN,2014,V,1,31,555,I,467,0,10,L'alternative responsable,A remplir,12
289,94,1110,641,11,630,469,MN,2014,V,1,31,555,I,641,0,10,L'alternative responsable,A remplir,12
290,107,1019,581,8,573,438,MN,2014,V,1,31,555,I,581,0,10,L'alternative responsable,A remplir,8
291,110,918,502,13,489,416,MN,2014,V,1,31,555,I,502,0,10,L'alternative responsable,A remplir,3
292,134A,1406,745,22,723,661,MN,2014,V,1,31,555,I,745,0,10,L'alternative responsable,A remplir,14
293,146,833,440,3,437,393,MN,2014,V,1,31,555,I,440,0,10,L'alternative responsable,A remplir,12
294,186,1299,322,18,304,977,MN,2014,V,1,31,555,I,322,0,10,L'alternative responsable,A remplir,6
295,195A,1090,474,13,461,616,MN,2014,V,1,31,555,I,474,0,10,L'alternative responsable,A remplir,9
296,16,947,558,10,548,389,MN,2014,V,1,31,555,I,558,0,10,L'alternative responsable,A remplir,9
297,39A,938,525,28,497,413,MN,2014,V,1,31,555,I,525,0,10,L'alternative responsable,A remplir,16
298,85,994,452,13,439,542,MN,2014,V,1,31,555,I,452,0,10,L'alternative responsable,A remplir,13
299,87,1204,619,8,612,585,MN,2014,V,1,31,555,I,619,0,10,L'alternative responsable,A remplir,6
300,93B,1235,656,16,640,579,MN,2014,V,1,31,555,I,656,0,10,L'alternative responsable,A remplir,15
301,101,1126,627,10,617,499,MN,2014,V,1,31,555,I,627,0,10,L'alternative responsable,A remplir,19
302,104,1042,609,21,588,433,MN,2014,V,1,31,555,I,609,0,10,L'alternative responsable,A remplir,21
303,112,841,429,10,419,412,MN,2014,V,1,31,555,I,429,0,10,L'alternative responsable,A remplir,4
304,148,830,418,14,404,412,MN,2014,V,1,31,555,I,418,0,10,L'alternative responsable,A remplir,7
305,207,1141,602,18,584,539,MN,2014,V,1,31,555,I,602,0,10,L'alternative responsable,A remplir,13
306,210,1252,597,16,581,655,MN,2014,V,1,31,555,I,597,0,10,L'alternative responsable,A remplir,9
307,10,979,521,13,508,458,MN,2014,V,1,31,555,I,521,0,10,L'alternative responsable,A remplir,16
308,77,976,544,9,535,432,MN,2014,V,1,31,555,I,544,0,10,L'alternative responsable,A remplir,13
309,91,1000,523,15,508,477,MN,2014,V,1,31,555,I,523,0,10,L'alternative responsable,A remplir,5
310,132,1073,553,5,548,520,MN,2014,V,1,31,555,I,553,0,10,L'alternative responsable,A remplir,12
311,189,832,311,8,303,521,MN,2014,V,1,31,555,I,311,0,10,L'alternative responsable,A remplir,5
312,193A,795,360,9,351,435,MN,2014,V,1,31,555,I,360,0,10,L'alternative responsable,A remplir,4
313,209,1102,507,22,485,595,MN,2014,V,1,31,555,I,507,0,10,L'alternative responsable,A remplir,6
314,212,442,187,4,183,255,MN,2014,V,1,31,555,I,187,0,10,L'alternative responsable,A remplir,5
315,4,956,571,10,561,385,MN,2014,V,1,31,555,I,571,0,10,L'alternative responsable,A remplir,36
316,19,1084,637,8,631,447,MN,2014,V,1,31,555,I,637,0,10,L'alternative responsable,A remplir,21
317,30,992,554,7,547,438,MN,2014,V,1,31,555,I,554,0,10,L'alternative responsable,A remplir,21
318,56,1025,487,8,479,538,MN,2014,V,1,31,555,I,487,0,10,L'alternative responsable,A remplir,17
319,84,1173,642,7,635,531,MN,2014,V,1,31,555,I,642,0,10,L'alternative responsable,A remplir,20
320,93A,1276,661,14,647,615,MN,2014,V,1,31,555,I,661,0,10,L'alternative responsable,A remplir,9
321,144,991,611,13,598,380,MN,2014,V,1,31,555,I,611,0,10,L'alternative responsable,A remplir,17
322,22,1086,605,16,589,481,MN,2014,V,1,31,555,I,605,0,10,L'alternative responsable,A remplir,24
323,25,1083,547,7,540,536,MN,2014,V,1,31,555,I,547,0,10,L'alternative responsable,A remplir,14
324,73,1069,531,13,518,538,MN,2014,V,1,31,555,I,531,0,10,L'alternative responsable,A remplir,25
325,99,933,486,11,475,447,MN,2014,V,1,31,555,I,486,0,10,L'alternative responsable,A remplir,7
326,103,871,459,18,441,412,MN,2014,V,1,31,555,I,459,0,10,L'alternative responsable,A remplir,7
327,140,935,559,9,550,376,MN,2014,V,1,31,555,I,559,0,10,L'alternative responsable,A remplir,11
328,150,1022,574,6,568,448,MN,2014,V,1,31,555,I,574,0,10,L'alternative responsable,A remplir,11
329,168,934,464,17,447,470,MN,2014,V,1,31,555,I,464,0,10,L'alternative responsable,A remplir,10
330,22A,1047,587,16,571,460,MN,2014,V,1,31,555,I,587,0,10,L'alternative responsable,A remplir,22
331,52,1066,539,12,527,527,MN,2014,V,1,31,555,I,539,0,10,L'alternative responsable,A remplir,12
332,66,862,474,16,458,388,MN,2014,V,1,31,555,I,474,0,10,L'alternative responsable,A remplir,16
333,96,978,542,17,525,436,MN,2014,V,1,31,555,I,542,0,10,L'alternative responsable,A remplir,11
334,118,1142,631,12,619,511,MN,2014,V,1,31,555,I,631,0,10,L'alternative responsable,A remplir,12
335,139,965,529,11,518,436,MN,2014,V,1,31,555,I,529,0,10,L'alternative responsable,A remplir,8
336,141,957,569,8,561,388,MN,2014,V,1,31,555,I,569,0,10,L'alternative responsable,A remplir,17
337,164,1183,491,16,475,692,MN,2014,V,1,31,555,I,491,0,10,L'alternative responsable,A remplir,13
338,181,931,370,12,358,561,MN,2014,V,1,31,555,I,370,0,10,L'alternative responsable,A remplir,8
339,211A,1286,623,28,595,663,MN,2014,V,1,31,555,I,623,0,10,L'alternative responsable,A remplir,13
340,2,931,505,12,493,426,MN,2014,V,1,31,555,I,505,0,10,L'alternative responsable,A remplir,13
341,9,941,528,3,525,413,MN,2014,V,1,31,555,I,528,0,10,L'alternative responsable,A remplir,23
342,40,1276,595,11,584,681,MN,2014,V,1,31,555,I,595,0,10,L'alternative responsable,A remplir,21
343,59,1038,581,10,571,457,MN,2014,V,1,31,555,I,581,0,10,L'alternative responsable,A remplir,14
344,88,1122,596,12,584,526,MN,2014,V,1,31,555,I,596,0,10,L'alternative responsable,A remplir,6
345,106,962,481,17,465,481,MN,2014,V,1,31,555,I,481,0,10,L'alternative responsable,A remplir,3
346,120,1058,610,18,592,448,MN,2014,V,1,31,555,I,610,0,10,L'alternative responsable,A remplir,18
347,145,1015,549,14,535,466,MN,2014,V,1,31,555,I,549,0,10,L'alternative responsable,A remplir,7
348,149,1123,622,12,610,501,MN,2014,V,1,31,555,I,622,0,10,L'alternative responsable,A remplir,11
349,201B,1032,580,19,561,452,MN,2014,V,1,31,555,I,580,0,10,L'alternative responsable,A remplir,14
350,206,1087,549,20,529,538,MN,2014,V,1,31,555,I,549,0,10,L'alternative responsable,A remplir,13
351,55,1082,614,14,600,468,MN,2014,V,1,31,555,I,614,0,10,L'alternative responsable,A remplir,16
352,83,1176,712,10,702,464,MN,2014,V,1,31,555,I,712,0,10,L'alternative responsable,A remplir,19
353,136,730,449,8,442,281,MN,2014,V,1,31,555,I,449,0,10,L'alternative responsable,A remplir,8
354,158,1155,634,10,624,521,MN,2014,V,1,31,555,I,634,0,10,L'alternative responsable,A remplir,4
355,162,1033,534,12,522,499,MN,2014,V,1,31,555,I,534,0,10,L'alternative responsable,A remplir,7
356,170,819,446,8,438,373,MN,2014,V,1,31,555,I,446,0,10,L'alternative responsable,A remplir,10
357,172,870,533,11,522,337,MN,2014,V,1,31,555,I,533,0,10,L'alternative responsable,A remplir,19
358,222,1321,665,21,644,656,MN,2014,V,1,31,555,I,665,0,10,L'alternative responsable,A remplir,11
359,7,928,450,9,441,478,MN,2014,V,1,31,555,I,450,0,10,L'alternative responsable,A remplir,12
360,11,1115,633,14,620,482,MN,2014,V,1,31,555,I,633,0,10,L'alternative responsable,A remplir,22
361,21,944,561,12,549,383,MN,2014,V,1,31,555,I,561,0,10,L'alternative responsable,A remplir,26
362,53,1067,569,13,556,498,MN,2014,V,1,31,555,I,569,0,10,L'alternative responsable,A remplir,19
363,122,1038,637,5,632,401,MN,2014,V,1,31,555,I,637,0,10,L'alternative responsable,A remplir,17
364,124,1082,650,16,634,432,MN,2014,V,1,31,555,I,650,0,10,L'alternative responsable,A remplir,7
365,129,990,483,16,467,507,MN,2014,V,1,31,555,I,483,0,10,L'alternative responsable,A remplir,6
366,134,875,516,10,506,359,MN,2014,V,1,31,555,I,516,0,10,L'alternative responsable,A remplir,7
367,135,1027,636,7,630,391,MN,2014,V,1,31,555,I,636,0,10,L'alternative responsable,A remplir,3
368,175,995,320,11,309,675,MN,2014,V,1,31,555,I,320,0,10,L'alternative responsable,A remplir,3
369,177,1084,439,24,415,645,MN,2014,V,1,31,555,I,439,0,10,L'alternative responsable,A remplir,1
370,193,650,268,4,264,382,MN,2014,V,1,31,555,I,268,0,10,L'alternative responsable,A remplir,1
371,199,503,252,4,248,251,MN,2014,V,1,31,555,I,252,0,10,L'alternative responsable,A remplir,4
372,213,1101,583,17,566,518,MN,2014,V,1,31,555,I,583,0,10,L'alternative responsable,A remplir,22
373,219,1138,614,10,604,524,MN,2014,V,1,31,555,I,614,0,10,L'alternative responsable,A remplir,13
374,12,1116,608,12,596,508,MN,2014,V,1,31,555,I,608,0,10,L'alternative responsable,A remplir,13
375,31,1020,561,8,553,459,MN,2014,V,1,31,555,I,561,0,10,L'alternative responsable,A remplir,23
376,36,806,435,14,421,371,MN,2014,V,1,31,555,I,435,0,10,L'alternative responsable,A remplir,13
377,46,986,558,11,547,428,MN,2014,V,1,31,555,I,558,0,10,L'alternative responsable,A remplir,12
378,81,1177,499,16,483,678,MN,2014,V,1,31,555,I,499,0,10,L'alternative responsable,A remplir,18
379,142,890,459,6,453,431,MN,2014,V,1,31,555,I,459,0,10,L'alternative responsable,A remplir,11
380,152,944,355,14,341,589,MN,2014,V,1,31,555,I,355,0,10,L'alternative responsable,A remplir,5
381,167,995,543,9,534,452,MN,2014,V,1,31,555,I,543,0,10,L'alternative responsable,A remplir,15
382,190,1008,247,9,238,761,MN,2014,V,1,31,555,I,247,0,10,L'alternative responsable,A remplir,5
383,225,838,451,16,435,387,MN,2014,V,1,31,555,I,451,0,10,L'alternative responsable,A remplir,9
384,49,759,440,8,432,319,MN,2014,V,1,31,555,I,440,0,10,L'alternative responsable,A remplir,10
385,50,977,533,16,517,444,MN,2014,V,1,31,555,I,533,0,10,L'alternative responsable,A remplir,16
386,60,1164,611,25,586,553,MN,2014,V,1,31,555,I,611,0,10,L'alternative responsable,A remplir,16
387,108A,939,523,13,510,416,MN,2014,V,1,31,555,I,523,0,10,L'alternative responsable,A remplir,8
388,125,957,575,11,564,382,MN,2014,V,1,31,555,I,575,0,10,L'alternative responsable,A remplir,9
389,182,794,435,10,425,359,MN,2014,V,1,31,555,I,435,0,10,L'alternative responsable,A remplir,24
390,215,1373,629,18,611,744,MN,2014,V,1,31,555,I,629,0,10,L'alternative responsable,A remplir,16
391,1,1100,541,10,532,559,MN,2014,V,1,31,555,I,541,0,10,L'alternative responsable,A remplir,21
392,44,971,558,16,542,413,MN,2014,V,1,31,555,I,558,0,10,L'alternative responsable,A remplir,16
393,49A,856,513,8,505,343,MN,2014,V,1,31,555,I,513,0,10,L'alternative responsable,A remplir,11
394,165A,982,609,11,598,373,MN,2014,V,1,31,555,I,609,0,10,L'alternative responsable,A remplir,22
395,200,1192,654,15,639,538,MN,2014,V,1,31,555,I,654,0,10,L'alternative responsable,A remplir,24
396,5,772,439,10,429,333,MN,2014,V,1,31,555,I,439,0,10,L'alternative responsable,A remplir,33
397,24,1061,543,8,535,518,MN,2014,V,1,31,555,I,543,0,10,L'alternative responsable,A remplir,12
398,25A,1002,518,11,507,484,MN,2014,V,1,31,555,I,518,0,10,L'alternative responsable,A remplir,18
399,51,1230,659,18,641,571,MN,2014,V,1,31,555,I,659,0,10,L'alternative responsable,A remplir,11
400,71,941,513,10,504,428,MN,2014,V,1,31,555,I,513,0,10,L'alternative responsable,A remplir,6
401,78,1006,624,19,605,382,MN,2014,V,1,31,555,I,624,0,10,L'alternative responsable,A remplir,11
402,79,915,498,6,491,417,MN,2014,V,1,31,555,I,498,0,10,L'alternative responsable,A remplir,8
403,80,1173,553,9,544,620,MN,2014,V,1,31,555,I,553,0,10,L'alternative responsable,A remplir,19
404,97,1084,564,10,553,520,MN,2014,V,1,31,555,I,564,0,10,L'alternative responsable,A remplir,5
405,184,1151,355,10,345,796,MN,2014,V,1,31,555,I,355,0,10,L'alternative responsable,A remplir,6
406,188,1220,497,20,477,723,MN,2014,V,1,31,555,I,497,0,10,L'alternative responsable,A remplir,6
407,8,891,480,13,467,411,MN,2014,V,1,31,555,I,480,0,10,L'alternative responsable,A remplir,13
408,14,1014,595,6,589,419,MN,2014,V,1,31,555,I,595,0,10,L'alternative responsable,A remplir,25
409,34,953,496,10,486,457,MN,2014,V,1,31,555,I,496,0,10,L'alternative responsable,A remplir,9
410,39,1160,603,12,591,557,MN,2014,V,1,31,555,I,603,0,10,L'alternative responsable,A remplir,8
411,63,806,314,6,308,492,MN,2014,V,1,31,555,I,314,0,10,L'alternative responsable,A remplir,3
412,124A,982,582,15,567,400,MN,2014,V,1,31,555,I,582,0,10,L'alternative responsable,A remplir,17
413,205,1184,651,18,633,533,MN,2014,V,1,31,555,I,651,0,10,L'alternative responsable,A remplir,16
414,6,1098,531,11,520,567,MN,2014,V,1,31,555,I,531,0,10,L'alternative responsable,A remplir,21
415,23,1205,614,7,607,591,MN,2014,V,1,31,555,I,614,0,10,L'alternative responsable,A remplir,17
416,64,1233,675,22,653,558,MN,2014,V,1,31,555,I,675,0,10,L'alternative responsable,A remplir,19
417,75,949,456,15,441,493,MN,2014,V,1,31,555,I,456,0,10,L'alternative responsable,A remplir,8
418,76,1007,517,7,510,490,MN,2014,V,1,31,555,I,517,0,10,L'alternative responsable,A remplir,15
419,111,956,511,10,501,445,MN,2014,V,1,31,555,I,511,0,10,L'alternative responsable,A remplir,12
420,123,1134,589,8,581,545,MN,2014,V,1,31,555,I,589,0,10,L'alternative responsable,A remplir,3
421,131,1051,602,12,590,449,MN,2014,V,1,31,555,I,602,0,10,L'alternative responsable,A remplir,13
422,154,809,278,13,265,531,MN,2014,V,1,31,555,I,278,0,10,L'alternative responsable,A remplir,4
423,179,709,357,9,348,352,MN,2014,V,1,31,555,I,357,0,10,L'alternative responsable,A remplir,11
424,211,1377,732,18,714,645,MN,2014,V,1,31,555,I,732,0,10,L'alternative responsable,A remplir,20
425,13,1041,588,11,577,453,MN,2014,V,1,31,555,I,588,0,10,L'alternative responsable,A remplir,12
426,15,1078,643,10,633,435,MN,2014,V,1,31,555,I,643,0,10,L'alternative responsable,A remplir,12
427,27,1122,647,10,637,475,MN,2014,V,1,31,555,I,647,0,10,L'alternative responsable,A remplir,15
428,36A,1124,605,14,591,519,MN,2014,V,1,31,555,I,605,0,10,L'alternative responsable,A remplir,22
429,56A,894,469,9,460,425,MN,2014,V,1,31,555,I,469,0,10,L'alternative responsable,A remplir,11
430,69,1090,574,12,562,516,MN,2014,V,1,31,555,I,574,0,10,L'alternative responsable,A remplir,12
431,113,1030,455,18,437,575,MN,2014,V,1,31,555,I,455,0,10,L'alternative responsable,A remplir,4
432,147,1006,591,11,580,415,MN,2014,V,1,31,555,I,591,0,10,L'alternative responsable,A remplir,9
433,165,1463,797,24,773,666,MN,2014,V,1,31,555,I,797,0,10,L'alternative responsable,A remplir,15
434,201A,1154,711,21,690,443,MN,2014,V,1,31,555,I,711,0,10,L'alternative responsable,A remplir,20
435,204,1153,587,18,569,566,MN,2014,V,1,31,555,I,587,0,10,L'alternative responsable,A remplir,12
436,218,1264,701,15,686,563,MN,2014,V,1,31,555,I,701,0,10,L'alternative responsable,A remplir,10
437,220,1242,685,19,666,557,MN,2014,V,1,31,555,I,685,0,10,L'alternative responsable,A remplir,16
438,42,962,516,14,502,446,MN,2014,V,1,31,555,I,516,0,10,L'alternative responsable,A remplir,37
439,58,1199,536,13,523,663,MN,2014,V,1,31,555,I,536,0,10,L'alternative responsable,A remplir,12
440,95,1039,530,11,519,509,MN,2014,V,1,31,555,I,530,0,10,L'alternative responsable,A remplir,13
441,116,1060,541,13,528,519,MN,2014,V,1,31,555,I,541,0,10,L'alternative responsable,A remplir,4
442,151,983,544,9,535,439,MN,2014,V,1,31,555,I,544,0,10,L'alternative responsable,A remplir,7
443,155,726,257,7,250,469,MN,2014,V,1,31,555,I,257,0,10,L'alternative responsable,A remplir,3
444,198B,1072,625,17,608,447,MN,2014,V,1,31,555,I,625,0,10,L'alternative responsable,A remplir,19
445,201,1015,630,10,620,385,MN,2014,V,1,31,555,I,630,0,10,L'alternative responsable,A remplir,19
446,224,780,412,11,401,368,MN,2014,V,1,31,555,I,412,0,10,L'alternative responsable,A remplir,14
447,17,940,535,10,525,405,MN,2014,V,1,31,555,I,535,0,10,L'alternative responsable,A remplir,7
448,65,1142,646,19,627,496,MN,2014,V,1,31,555,I,646,0,10,L'alternative responsable,A remplir,20
449,67,983,550,21,529,433,MN,2014,V,1,31,555,I,550,0,10,L'alternative responsable,A remplir,14
450,102,739,369,8,361,370,MN,2014,V,1,31,555,I,369,0,10,L'alternative responsable,A remplir,9
451,113A,976,526,13,513,450,MN,2014,V,1,31,555,I,526,0,10,L'alternative responsable,A remplir,7
452,119,970,576,9,567,394,MN,2014,V,1,31,555,I,576,0,10,L'alternative responsable,A remplir,13
453,191A,925,327,20,307,598,MN,2014,V,1,31,555,I,327,0,10,L'alternative responsable,A remplir,3
454,198,1241,700,19,681,541,MN,2014,V,1,31,555,I,700,0,10,L'alternative responsable,A remplir,14
455,208,1196,696,27,669,500,MN,2014,V,1,31,555,I,696,0,10,L'alternative responsable,A remplir,14
456,32,848,516,8,508,332,MN,2014,V,1,31,555,I,516,0,10,L'alternative responsable,A remplir,25
457,33,1059,631,17,614,428,MN,2014,V,1,31,555,I,631,0,10,L'alternative responsable,A remplir,15
458,44B,805,394,16,378,411,MN,2014,V,1,31,555,I,394,0,10,L'alternative responsable,A remplir,10
459,54,991,513,15,497,478,MN,2014,V,1,31,555,I,513,0,10,L'alternative responsable,A remplir,12
460,92,1184,581,19,562,603,MN,2014,V,1,31,555,I,581,0,10,L'alternative responsable,A remplir,12
461,93,1248,671,22,649,577,MN,2014,V,1,31,555,I,671,0,10,L'alternative responsable,A remplir,8
462,108,1029,598,16,582,431,MN,2014,V,1,31,555,I,598,0,10,L'alternative responsable,A remplir,17
463,138,889,558,15,543,331,MN,2014,V,1,31,555,I,558,0,10,L'alternative responsable,A remplir,6
464,153,706,148,5,143,558,MN,2014,V,1,31,555,I,148,0,10,L'alternative responsable,A remplir,1
465,163,1016,466,7,460,550,MN,2014,V,1,31,555,I,466,0,10,L'alternative responsable,A remplir,10
466,191,1000,255,12,243,745,MN,2014,V,1,31,555,I,255,0,10,L'alternative responsable,A remplir,1
467,197,994,590,20,570,404,MN,2014,V,1,31,555,I,590,0,10,L'alternative responsable,A remplir,16
468,198A,955,556,15,541,399,MN,2014,V,1,31,555,I,556,0,10,L'alternative responsable,A remplir,28
469,223,1190,637,21,616,553,MN,2014,V,1,31,555,I,637,0,10,L'alternative responsable,A remplir,21
470,226,987,505,6,499,482,MN,2014,V,1,31,555,I,505,0,10,L'alternative responsable,A remplir,13
471,37,890,465,15,450,425,MN,2014,V,1,31,555,I,465,0,10,L'alternative responsable,A remplir,9
472,70,1004,580,14,566,424,MN,2014,V,1,31,555,I,580,0,10,L'alternative responsable,A remplir,13
473,74,1059,538,7,531,521,MN,2014,V,1,31,555,I,538,0,10,L'alternative responsable,A remplir,25
474,178,970,371,10,361,599,MN,2014,V,1,31,555,I,371,0,10,L'alternative responsable,A remplir,3
475,10A,1006,494,11,483,512,MN,2014,V,1,31,555,I,494,0,10,L'alternative responsable,A remplir,24
476,29,1159,606,9,598,553,MN,2014,V,1,31,555,I,606,0,10,L'alternative responsable,A remplir,20
477,67A,929,482,11,471,447,MN,2014,V,1,31,555,I,482,0,10,L'alternative responsable,A remplir,8
478,100,1027,479,9,470,548,MN,2014,V,1,31,555,I,479,0,10,L'alternative responsable,A remplir,10
479,114,1108,530,15,515,578,MN,2014,V,1,31,555,I,530,0,10,L'alternative responsable,A remplir,6
480,126,911,511,9,502,400,MN,2014,V,1,31,555,I,511,0,10,L'alternative responsable,A remplir,16
481,130,1083,574,13,561,509,MN,2014,V,1,31,555,I,574,0,10,L'alternative responsable,A remplir,10
482,161,967,524,11,513,443,MN,2014,V,1,31,555,I,524,0,10,L'alternative responsable,A remplir,18
483,174,1101,559,8,551,542,MN,2014,V,1,31,555,I,559,0,10,L'alternative responsable,A remplir,13
484,202,1197,556,19,537,641,MN,2014,V,1,31,555,I,556,0,10,L'alternative responsable,A remplir,14
485,216,1186,583,17,566,603,MN,2014,V,1,31,555,I,583,0,10,L'alternative responsable,A remplir,17
486,216A,1122,459,20,439,663,MN,2014,V,1,31,555,I,459,0,10,L'alternative responsable,A remplir,18
487,20,1041,656,16,640,385,MN,2014,V,1,31,555,I,656,0,10,L'alternative responsable,A remplir,26
488,38,975,516,18,498,459,MN,2014,V,1,31,555,I,516,0,10,L'alternative responsable,A remplir,15
489,43,1026,583,21,562,443,MN,2014,V,1,31,555,I,583,0,10,L'alternative responsable,A remplir,24
490,133,983,556,15,541,427,MN,2014,V,1,31,555,I,556,0,10,L'alternative responsable,A remplir,6
491,138A,951,606,17,589,345,MN,2014,V,1,31,555,I,606,0,10,L'alternative responsable,A remplir,9
492,143,984,592,9,583,392,MN,2014,V,1,31,555,I,592,0,10,L'alternative responsable,A remplir,12
493,160,1056,563,10,553,493,MN,2014,V,1,31,555,I,563,0,10,L'alternative responsable,A remplir,29
494,180,755,275,2,273,480,MN,2014,V,1,31,555,I,275,0,10,L'alternative responsable,A remplir,4
495,195B,1078,677,18,659,401,MN,2014,V,1,31,555,I,677,0,10,L'alternative responsable,A remplir,13
496,196,1165,666,15,651,499,MN,2014,V,1,31,555,I,666,0,10,L'alternative responsable,A remplir,17
497,217,1275,630,18,612,645,MN,2014,V,1,31,555,I,630,0,10,L'alternative responsable,A remplir,14
498,28,1074,561,7,554,513,MN,2014,V,1,31,555,I,561,0,10,Toulouse en marche !,A remplir,6
499,41,975,548,11,537,427,MN,2014,V,1,31,555,I,548,0,10,Toulouse en marche !,A remplir,8
500,72,1046,510,5,505,536,MN,2014,V,1,31,555,I,510,0,10,Toulouse en marche !,A remplir,7
501,105,961,472,16,456,489,MN,2014,V,1,31,555,I,472,0,10,Toulouse en marche !,A remplir,8
502,109,1098,619,15,604,479,MN,2014,V,1,31,555,I,619,0,10,Toulouse en marche !,A remplir,9
503,117,1119,551,9,542,568,MN,2014,V,1,31,555,I,551,0,10,Toulouse en marche !,A remplir,6
504,121,1065,621,6,615,444,MN,2014,V,1,31,555,I,621,0,10,Toulouse en marche !,A remplir,5
505,171,1072,450,13,437,622,MN,2014,V,1,31,555,I,450,0,10,Toulouse en marche !,A remplir,16
506,174A,1093,484,9,475,609,MN,2014,V,1,31,555,I,484,0,10,Toulouse en marche !,A remplir,9
507,192,698,315,9,306,383,MN,2014,V,1,31,555,I,315,0,10,Toulouse en marche !,A remplir,12
508,194,863,405,15,390,458,MN,2014,V,1,31,555,I,405,0,10,Toulouse en marche !,A remplir,6
509,214,1312,659,16,643,653,MN,2014,V,1,31,555,I,659,0,10,Toulouse en marche !,A remplir,10
510,3,919,501,10,491,418,MN,2014,V,1,31,555,I,501,0,10,Toulouse en marche !,A remplir,6
511,44A,1061,529,19,510,532,MN,2014,V,1,31,555,I,529,0,10,Toulouse en marche !,A remplir,6
512,47,1034,588,11,577,446,MN,2014,V,1,31,555,I,588,0,10,Toulouse en marche !,A remplir,6
513,62,1049,498,12,486,551,MN,2014,V,1,31,555,I,498,0,10,Toulouse en marche !,A remplir,12
514,82,976,490,12,478,486,MN,2014,V,1,31,555,I,490,0,10,Toulouse en marche !,A remplir,9
515,86,1070,542,8,534,528,MN,2014,V,1,31,555,I,542,0,10,Toulouse en marche !,A remplir,13
516,127,908,537,9,528,371,MN,2014,V,1,31,555,I,537,0,10,Toulouse en marche !,A remplir,6
517,156,889,425,11,414,464,MN,2014,V,1,31,555,I,425,0,10,Toulouse en marche !,A remplir,7
518,159,1232,667,12,655,565,MN,2014,V,1,31,555,I,667,0,10,Toulouse en marche !,A remplir,7
519,169,953,362,11,351,591,MN,2014,V,1,31,555,I,362,0,10,Toulouse en marche !,A remplir,6
520,173,962,388,8,380,574,MN,2014,V,1,31,555,I,388,0,10,Toulouse en marche !,A remplir,26
521,203,848,421,16,405,427,MN,2014,V,1,31,555,I,421,0,10,Toulouse en marche !,A remplir,4
522,203B,1049,585,16,569,464,MN,2014,V,1,31,555,I,585,0,10,Toulouse en marche !,A remplir,9
523,18,1208,703,23,680,505,MN,2014,V,1,31,555,I,703,0,10,Toulouse en marche !,A remplir,11
524,48,1004,509,11,498,495,MN,2014,V,1,31,555,I,509,0,10,Toulouse en marche !,A remplir,17
525,57,882,517,18,499,365,MN,2014,V,1,31,555,I,517,0,10,Toulouse en marche !,A remplir,4
526,68,1002,582,23,559,420,MN,2014,V,1,31,555,I,582,0,10,Toulouse en marche !,A remplir,4
527,128,1114,576,22,554,538,MN,2014,V,1,31,555,I,576,0,10,Toulouse en marche !,A remplir,5
528,137,995,617,10,607,378,MN,2014,V,1,31,555,I,617,0,10,Toulouse en marche !,A remplir,3
529,144A,992,563,13,551,429,MN,2014,V,1,31,555,I,563,0,10,Toulouse en marche !,A remplir,4
530,157,1208,645,11,634,563,MN,2014,V,1,31,555,I,645,0,10,Toulouse en marche !,A remplir,10
531,166,1147,666,12,653,481,MN,2014,V,1,31,555,I,666,0,10,Toulouse en marche !,A remplir,16
532,195,811,443,7,436,368,MN,2014,V,1,31,555,I,443,0,10,Toulouse en marche !,A remplir,9
533,200A,1064,537,13,524,527,MN,2014,V,1,31,555,I,537,0,10,Toulouse en marche !,A remplir,5
534,203A,817,451,6,445,366,MN,2014,V,1,31,555,I,451,0,10,Toulouse en marche !,A remplir,6
535,35,1057,526,10,516,531,MN,2014,V,1,31,555,I,526,0,10,Toulouse en marche !,A remplir,9
536,45,1038,429,8,421,609,MN,2014,V,1,31,555,I,429,0,10,Toulouse en marche !,A remplir,10
537,61,859,467,16,451,392,MN,2014,V,1,31,555,I,467,0,10,Toulouse en marche !,A remplir,11
538,94,1110,641,11,630,469,MN,2014,V,1,31,555,I,641,0,10,Toulouse en marche !,A remplir,12
539,107,1019,581,8,573,438,MN,2014,V,1,31,555,I,581,0,10,Toulouse en marche !,A remplir,3
540,110,918,502,13,489,416,MN,2014,V,1,31,555,I,502,0,10,Toulouse en marche !,A remplir,3
541,134A,1406,745,22,723,661,MN,2014,V,1,31,555,I,745,0,10,Toulouse en marche !,A remplir,11
542,146,833,440,3,437,393,MN,2014,V,1,31,555,I,440,0,10,Toulouse en marche !,A remplir,17
543,186,1299,322,18,304,977,MN,2014,V,1,31,555,I,322,0,10,Toulouse en marche !,A remplir,32
544,195A,1090,474,13,461,616,MN,2014,V,1,31,555,I,474,0,10,Toulouse en marche !,A remplir,12
545,16,947,558,10,548,389,MN,2014,V,1,31,555,I,558,0,10,Toulouse en marche !,A remplir,12
546,39A,938,525,28,497,413,MN,2014,V,1,31,555,I,525,0,10,Toulouse en marche !,A remplir,14
547,85,994,452,13,439,542,MN,2014,V,1,31,555,I,452,0,10,Toulouse en marche !,A remplir,5
548,87,1204,619,8,612,585,MN,2014,V,1,31,555,I,619,0,10,Toulouse en marche !,A remplir,10
549,93B,1235,656,16,640,579,MN,2014,V,1,31,555,I,656,0,10,Toulouse en marche !,A remplir,2
550,101,1126,627,10,617,499,MN,2014,V,1,31,555,I,627,0,10,Toulouse en marche !,A remplir,13
551,104,1042,609,21,588,433,MN,2014,V,1,31,555,I,609,0,10,Toulouse en marche !,A remplir,4
552,112,841,429,10,419,412,MN,2014,V,1,31,555,I,429,0,10,Toulouse en marche !,A remplir,6
553,148,830,418,14,404,412,MN,2014,V,1,31,555,I,418,0,10,Toulouse en marche !,A remplir,7
554,207,1141,602,18,584,539,MN,2014,V,1,31,555,I,602,0,10,Toulouse en marche !,A remplir,9
555,210,1252,597,16,581,655,MN,2014,V,1,31,555,I,597,0,10,Toulouse en marche !,A remplir,10
556,10,979,521,13,508,458,MN,2014,V,1,31,555,I,521,0,10,Toulouse en marche !,A remplir,4
557,77,976,544,9,535,432,MN,2014,V,1,31,555,I,544,0,10,Toulouse en marche !,A remplir,8
558,91,1000,523,15,508,477,MN,2014,V,1,31,555,I,523,0,10,Toulouse en marche !,A remplir,14
559,132,1073,553,5,548,520,MN,2014,V,1,31,555,I,553,0,10,Toulouse en marche !,A remplir,3
560,189,832,311,8,303,521,MN,2014,V,1,31,555,I,311,0,10,Toulouse en marche !,A remplir,12
561,193A,795,360,9,351,435,MN,2014,V,1,31,555,I,360,0,10,Toulouse en marche !,A remplir,23
562,209,1102,507,22,485,595,MN,2014,V,1,31,555,I,507,0,10,Toulouse en marche !,A remplir,7
563,212,442,187,4,183,255,MN,2014,V,1,31,555,I,187,0,10,Toulouse en marche !,A remplir,3
564,4,956,571,10,561,385,MN,2014,V,1,31,555,I,571,0,10,Toulouse en marche !,A remplir,4
565,19,1084,637,8,631,447,MN,2014,V,1,31,555,I,637,0,10,Toulouse en marche !,A remplir,7
566,30,992,554,7,547,438,MN,2014,V,1,31,555,I,554,0,10,Toulouse en marche !,A remplir,4
567,56,1025,487,8,479,538,MN,2014,V,1,31,555,I,487,0,10,Toulouse en marche !,A remplir,9
568,84,1173,642,7,635,531,MN,2014,V,1,31,555,I,642,0,10,Toulouse en marche !,A remplir,12
569,93A,1276,661,14,647,615,MN,2014,V,1,31,555,I,661,0,10,Toulouse en marche !,A remplir,15
570,144,991,611,13,598,380,MN,2014,V,1,31,555,I,611,0,10,Toulouse en marche !,A remplir,4
571,22,1086,605,16,589,481,MN,2014,V,1,31,555,I,605,0,10,Toulouse en marche !,A remplir,3
572,25,1083,547,7,540,536,MN,2014,V,1,31,555,I,547,0,10,Toulouse en marche !,A remplir,14
573,73,1069,531,13,518,538,MN,2014,V,1,31,555,I,531,0,10,Toulouse en marche !,A remplir,8
574,99,933,486,11,475,447,MN,2014,V,1,31,555,I,486,0,10,Toulouse en marche !,A remplir,8
575,103,871,459,18,441,412,MN,2014,V,1,31,555,I,459,0,10,Toulouse en marche !,A remplir,1
576,140,935,559,9,550,376,MN,2014,V,1,31,555,I,559,0,10,Toulouse en marche !,A remplir,4
577,150,1022,574,6,568,448,MN,2014,V,1,31,555,I,574,0,10,Toulouse en marche !,A remplir,7
578,168,934,464,17,447,470,MN,2014,V,1,31,555,I,464,0,10,Toulouse en marche !,A remplir,16
579,22A,1047,587,16,571,460,MN,2014,V,1,31,555,I,587,0,10,Toulouse en marche !,A remplir,6
580,52,1066,539,12,527,527,MN,2014,V,1,31,555,I,539,0,10,Toulouse en marche !,A remplir,12
581,66,862,474,16,458,388,MN,2014,V,1,31,555,I,474,0,10,Toulouse en marche !,A remplir,9
582,96,978,542,17,525,436,MN,2014,V,1,31,555,I,542,0,10,Toulouse en marche !,A remplir,7
583,118,1142,631,12,619,511,MN,2014,V,1,31,555,I,631,0,10,Toulouse en marche !,A remplir,8
584,139,965,529,11,518,436,MN,2014,V,1,31,555,I,529,0,10,Toulouse en marche !,A remplir,5
585,141,957,569,8,561,388,MN,2014,V,1,31,555,I,569,0,10,Toulouse en marche !,A remplir,2
586,164,1183,491,16,475,692,MN,2014,V,1,31,555,I,491,0,10,Toulouse en marche !,A remplir,12
587,181,931,370,12,358,561,MN,2014,V,1,31,555,I,370,0,10,Toulouse en marche !,A remplir,21
588,211A,1286,623,28,595,663,MN,2014,V,1,31,555,I,623,0,10,Toulouse en marche !,A remplir,6
589,2,931,505,12,493,426,MN,2014,V,1,31,555,I,505,0,10,Toulouse en marche !,A remplir,3
590,9,941,528,3,525,413,MN,2014,V,1,31,555,I,528,0,10,Toulouse en marche !,A remplir,8
591,40,1276,595,11,584,681,MN,2014,V,1,31,555,I,595,0,10,Toulouse en marche !,A remplir,13
592,59,1038,581,10,571,457,MN,2014,V,1,31,555,I,581,0,10,Toulouse en marche !,A remplir,9
593,88,1122,596,12,584,526,MN,2014,V,1,31,555,I,596,0,10,Toulouse en marche !,A remplir,5
594,106,962,481,17,465,481,MN,2014,V,1,31,555,I,481,0,10,Toulouse en marche !,A remplir,12
595,120,1058,610,18,592,448,MN,2014,V,1,31,555,I,610,0,10,Toulouse en marche !,A remplir,3
596,145,1015,549,14,535,466,MN,2014,V,1,31,555,I,549,0,10,Toulouse en marche !,A remplir,10
597,149,1123,622,12,610,501,MN,2014,V,1,31,555,I,622,0,10,Toulouse en marche !,A remplir,11
598,201B,1032,580,19,561,452,MN,2014,V,1,31,555,I,580,0,10,Toulouse en marche !,A remplir,4
599,206,1087,549,20,529,538,MN,2014,V,1,31,555,I,549,0,10,Toulouse en marche !,A remplir,7
600,55,1082,614,14,600,468,MN,2014,V,1,31,555,I,614,0,10,Toulouse en marche !,A remplir,8
601,83,1176,712,10,702,464,MN,2014,V,1,31,555,I,712,0,10,Toulouse en marche !,A remplir,13
602,136,730,449,8,442,281,MN,2014,V,1,31,555,I,449,0,10,Toulouse en marche !,A remplir,5
603,158,1155,634,10,624,521,MN,2014,V,1,31,555,I,634,0,10,Toulouse en marche !,A remplir,6
604,162,1033,534,12,522,499,MN,2014,V,1,31,555,I,534,0,10,Toulouse en marche !,A remplir,10
605,170,819,446,8,438,373,MN,2014,V,1,31,555,I,446,0,10,Toulouse en marche !,A remplir,9
606,172,870,533,11,522,337,MN,2014,V,1,31,555,I,533,0,10,Toulouse en marche !,A remplir,2
607,222,1321,665,21,644,656,MN,2014,V,1,31,555,I,665,0,10,Toulouse en marche !,A remplir,16
608,7,928,450,9,441,478,MN,2014,V,1,31,555,I,450,0,10,Toulouse en marche !,A remplir,5
609,11,1115,633,14,620,482,MN,2014,V,1,31,555,I,633,0,10,Toulouse en marche !,A remplir,3
610,21,944,561,12,549,383,MN,2014,V,1,31,555,I,561,0,10,Toulouse en marche !,A remplir,7
611,53,1067,569,13,556,498,MN,2014,V,1,31,555,I,569,0,10,Toulouse en marche !,A remplir,8
612,122,1038,637,5,632,401,MN,2014,V,1,31,555,I,637,0,10,Toulouse en marche !,A remplir,1
613,124,1082,650,16,634,432,MN,2014,V,1,31,555,I,650,0,10,Toulouse en marche !,A remplir,2
614,129,990,483,16,467,507,MN,2014,V,1,31,555,I,483,0,10,Toulouse en marche !,A remplir,5
615,134,875,516,10,506,359,MN,2014,V,1,31,555,I,516,0,10,Toulouse en marche !,A remplir,1
616,135,1027,636,7,630,391,MN,2014,V,1,31,555,I,636,0,10,Toulouse en marche !,A remplir,5
617,175,995,320,11,309,675,MN,2014,V,1,31,555,I,320,0,10,Toulouse en marche !,A remplir,29
618,177,1084,439,24,415,645,MN,2014,V,1,31,555,I,439,0,10,Toulouse en marche !,A remplir,17
619,193,650,268,4,264,382,MN,2014,V,1,31,555,I,268,0,10,Toulouse en marche !,A remplir,15
620,199,503,252,4,248,251,MN,2014,V,1,31,555,I,252,0,10,Toulouse en marche !,A remplir,6
621,213,1101,583,17,566,518,MN,2014,V,1,31,555,I,583,0,10,Toulouse en marche !,A remplir,11
622,219,1138,614,10,604,524,MN,2014,V,1,31,555,I,614,0,10,Toulouse en marche !,A remplir,16
623,12,1116,608,12,596,508,MN,2014,V,1,31,555,I,608,0,10,Toulouse en marche !,A remplir,7
624,31,1020,561,8,553,459,MN,2014,V,1,31,555,I,561,0,10,Toulouse en marche !,A remplir,3
625,36,806,435,14,421,371,MN,2014,V,1,31,555,I,435,0,10,Toulouse en marche !,A remplir,12
626,46,986,558,11,547,428,MN,2014,V,1,31,555,I,558,0,10,Toulouse en marche !,A remplir,5
627,81,1177,499,16,483,678,MN,2014,V,1,31,555,I,499,0,10,Toulouse en marche !,A remplir,6
628,142,890,459,6,453,431,MN,2014,V,1,31,555,I,459,0,10,Toulouse en marche !,A remplir,1
629,152,944,355,14,341,589,MN,2014,V,1,31,555,I,355,0,10,Toulouse en marche !,A remplir,6
630,167,995,543,9,534,452,MN,2014,V,1,31,555,I,543,0,10,Toulouse en marche !,A remplir,10
631,190,1008,247,9,238,761,MN,2014,V,1,31,555,I,247,0,10,Toulouse en marche !,A remplir,33
632,225,838,451,16,435,387,MN,2014,V,1,31,555,I,451,0,10,Toulouse en marche !,A remplir,15
633,49,759,440,8,432,319,MN,2014,V,1,31,555,I,440,0,10,Toulouse en marche !,A remplir,7
634,50,977,533,16,517,444,MN,2014,V,1,31,555,I,533,0,10,Toulouse en marche !,A remplir,11
635,60,1164,611,25,586,553,MN,2014,V,1,31,555,I,611,0,10,Toulouse en marche !,A remplir,6
636,108A,939,523,13,510,416,MN,2014,V,1,31,555,I,523,0,10,Toulouse en marche !,A remplir,5
637,125,957,575,11,564,382,MN,2014,V,1,31,555,I,575,0,10,Toulouse en marche !,A remplir,2
638,182,794,435,10,425,359,MN,2014,V,1,31,555,I,435,0,10,Toulouse en marche !,A remplir,8
639,215,1373,629,18,611,744,MN,2014,V,1,31,555,I,629,0,10,Toulouse en marche !,A remplir,6
640,1,1100,541,10,532,559,MN,2014,V,1,31,555,I,541,0,10,Toulouse en marche !,A remplir,5
641,44,971,558,16,542,413,MN,2014,V,1,31,555,I,558,0,10,Toulouse en marche !,A remplir,7
642,49A,856,513,8,505,343,MN,2014,V,1,31,555,I,513,0,10,Toulouse en marche !,A remplir,5
643,165A,982,609,11,598,373,MN,2014,V,1,31,555,I,609,0,10,Toulouse en marche !,A remplir,9
644,200,1192,654,15,639,538,MN,2014,V,1,31,555,I,654,0,10,Toulouse en marche !,A remplir,3
645,5,772,439,10,429,333,MN,2014,V,1,31,555,I,439,0,10,Toulouse en marche !,A remplir,1
646,24,1061,543,8,535,518,MN,2014,V,1,31,555,I,543,0,10,Toulouse en marche !,A remplir,7
647,25A,1002,518,11,507,484,MN,2014,V,1,31,555,I,518,0,10,Toulouse en marche !,A remplir,8
648,51,1230,659,18,641,571,MN,2014,V,1,31,555,I,659,0,10,Toulouse en marche !,A remplir,16
649,71,941,513,10,504,428,MN,2014,V,1,31,555,I,513,0,10,Toulouse en marche !,A remplir,10
650,78,1006,624,19,605,382,MN,2014,V,1,31,555,I,624,0,10,Toulouse en marche !,A remplir,5
651,79,915,498,6,491,417,MN,2014,V,1,31,555,I,498,0,10,Toulouse en marche !,A remplir,5
652,80,1173,553,9,544,620,MN,2014,V,1,31,555,I,553,0,10,Toulouse en marche !,A remplir,8
653,97,1084,564,10,553,520,MN,2014,V,1,31,555,I,564,0,10,Toulouse en marche !,A remplir,12
654,184,1151,355,10,345,796,MN,2014,V,1,31,555,I,355,0,10,Toulouse en marche !,A remplir,16
655,188,1220,497,20,477,723,MN,2014,V,1,31,555,I,497,0,10,Toulouse en marche !,A remplir,27
656,8,891,480,13,467,411,MN,2014,V,1,31,555,I,480,0,10,Toulouse en marche !,A remplir,6
657,14,1014,595,6,589,419,MN,2014,V,1,31,555,I,595,0,10,Toulouse en marche !,A remplir,8
658,34,953,496,10,486,457,MN,2014,V,1,31,555,I,496,0,10,Toulouse en marche !,A remplir,9
659,39,1160,603,12,591,557,MN,2014,V,1,31,555,I,603,0,10,Toulouse en marche !,A remplir,10
660,63,806,314,6,308,492,MN,2014,V,1,31,555,I,314,0,10,Toulouse en marche !,A remplir,7
661,124A,982,582,15,567,400,MN,2014,V,1,31,555,I,582,0,10,Toulouse en marche !,A remplir,3
662,205,1184,651,18,633,533,MN,2014,V,1,31,555,I,651,0,10,Toulouse en marche !,A remplir,9
663,6,1098,531,11,520,567,MN,2014,V,1,31,555,I,531,0,10,Toulouse en marche !,A remplir,7
664,23,1205,614,7,607,591,MN,2014,V,1,31,555,I,614,0,10,Toulouse en marche !,A remplir,12
665,64,1233,675,22,653,558,MN,2014,V,1,31,555,I,675,0,10,Toulouse en marche !,A remplir,11
666,75,949,456,15,441,493,MN,2014,V,1,31,555,I,456,0,10,Toulouse en marche !,A remplir,11
667,76,1007,517,7,510,490,MN,2014,V,1,31,555,I,517,0,10,Toulouse en marche !,A remplir,19
668,111,956,511,10,501,445,MN,2014,V,1,31,555,I,511,0,10,Toulouse en marche !,A remplir,6
669,123,1134,589,8,581,545,MN,2014,V,1,31,555,I,589,0,10,Toulouse en marche !,A remplir,5
670,131,1051,602,12,590,449,MN,2014,V,1,31,555,I,602,0,10,Toulouse en marche !,A remplir,7
671,154,809,278,13,265,531,MN,2014,V,1,31,555,I,278,0,10,Toulouse en marche !,A remplir,8
672,179,709,357,9,348,352,MN,2014,V,1,31,555,I,357,0,10,Toulouse en marche !,A remplir,13
673,211,1377,732,18,714,645,MN,2014,V,1,31,555,I,732,0,10,Toulouse en marche !,A remplir,6
674,13,1041,588,11,577,453,MN,2014,V,1,31,555,I,588,0,10,Toulouse en marche !,A remplir,10
675,15,1078,643,10,633,435,MN,2014,V,1,31,555,I,643,0,10,Toulouse en marche !,A remplir,6
676,27,1122,647,10,637,475,MN,2014,V,1,31,555,I,647,0,10,Toulouse en marche !,A remplir,7
677,36A,1124,605,14,591,519,MN,2014,V,1,31,555,I,605,0,10,Toulouse en marche !,A remplir,15
678,56A,894,469,9,460,425,MN,2014,V,1,31,555,I,469,0,10,Toulouse en marche !,A remplir,3
679,69,1090,574,12,562,516,MN,2014,V,1,31,555,I,574,0,10,Toulouse en marche !,A remplir,7
680,113,1030,455,18,437,575,MN,2014,V,1,31,555,I,455,0,10,Toulouse en marche !,A remplir,7
681,147,1006,591,11,580,415,MN,2014,V,1,31,555,I,591,0,10,Toulouse en marche !,A remplir,10
682,165,1463,797,24,773,666,MN,2014,V,1,31,555,I,797,0,10,Toulouse en marche !,A remplir,6
683,201A,1154,711,21,690,443,MN,2014,V,1,31,555,I,711,0,10,Toulouse en marche !,A remplir,5
684,204,1153,587,18,569,566,MN,2014,V,1,31,555,I,587,0,10,Toulouse en marche !,A remplir,6
685,218,1264,701,15,686,563,MN,2014,V,1,31,555,I,701,0,10,Toulouse en marche !,A remplir,11
686,220,1242,685,19,666,557,MN,2014,V,1,31,555,I,685,0,10,Toulouse en marche !,A remplir,15
687,42,962,516,14,502,446,MN,2014,V,1,31,555,I,516,0,10,Toulouse en marche !,A remplir,9
688,58,1199,536,13,523,663,MN,2014,V,1,31,555,I,536,0,10,Toulouse en marche !,A remplir,7
689,95,1039,530,11,519,509,MN,2014,V,1,31,555,I,530,0,10,Toulouse en marche !,A remplir,10
690,116,1060,541,13,528,519,MN,2014,V,1,31,555,I,541,0,10,Toulouse en marche !,A remplir,10
691,151,983,544,9,535,439,MN,2014,V,1,31,555,I,544,0,10,Toulouse en marche !,A remplir,5
692,155,726,257,7,250,469,MN,2014,V,1,31,555,I,257,0,10,Toulouse en marche !,A remplir,8
693,198B,1072,625,17,608,447,MN,2014,V,1,31,555,I,625,0,10,Toulouse en marche !,A remplir,14
694,201,1015,630,10,620,385,MN,2014,V,1,31,555,I,630,0,10,Toulouse en marche !,A remplir,3
695,224,780,412,11,401,368,MN,2014,V,1,31,555,I,412,0,10,Toulouse en marche !,A remplir,3
696,17,940,535,10,525,405,MN,2014,V,1,31,555,I,535,0,10,Toulouse en marche !,A remplir,3
697,65,1142,646,19,627,496,MN,2014,V,1,31,555,I,646,0,10,Toulouse en marche !,A remplir,9
698,67,983,550,21,529,433,MN,2014,V,1,31,555,I,550,0,10,Toulouse en marche !,A remplir,8
699,102,739,369,8,361,370,MN,2014,V,1,31,555,I,369,0,10,Toulouse en marche !,A remplir,8
700,113A,976,526,13,513,450,MN,2014,V,1,31,555,I,526,0,10,Toulouse en marche !,A remplir,1
701,119,970,576,9,567,394,MN,2014,V,1,31,555,I,576,0,10,Toulouse en marche !,A remplir,1
702,191A,925,327,20,307,598,MN,2014,V,1,31,555,I,327,0,10,Toulouse en marche !,A remplir,34
703,198,1241,700,19,681,541,MN,2014,V,1,31,555,I,700,0,10,Toulouse en marche !,A remplir,10
704,208,1196,696,27,669,500,MN,2014,V,1,31,555,I,696,0,10,Toulouse en marche !,A remplir,9
705,32,848,516,8,508,332,MN,2014,V,1,31,555,I,516,0,10,Toulouse en marche !,A remplir,1
706,33,1059,631,17,614,428,MN,2014,V,1,31,555,I,631,0,10,Toulouse en marche !,A remplir,8
707,44B,805,394,16,378,411,MN,2014,V,1,31,555,I,394,0,10,Toulouse en marche !,A remplir,9
708,54,991,513,15,497,478,MN,2014,V,1,31,555,I,513,0,10,Toulouse en marche !,A remplir,4
709,92,1184,581,19,562,603,MN,2014,V,1,31,555,I,581,0,10,Toulouse en marche !,A remplir,5
710,93,1248,671,22,649,577,MN,2014,V,1,31,555,I,671,0,10,Toulouse en marche !,A remplir,8
711,108,1029,598,16,582,431,MN,2014,V,1,31,555,I,598,0,10,Toulouse en marche !,A remplir,7
712,138,889,558,15,543,331,MN,2014,V,1,31,555,I,558,0,10,Toulouse en marche !,A remplir,2
713,153,706,148,5,143,558,MN,2014,V,1,31,555,I,148,0,10,Toulouse en marche !,A remplir,7
714,163,1016,466,7,460,550,MN,2014,V,1,31,555,I,466,0,10,Toulouse en marche !,A remplir,4
715,191,1000,255,12,243,745,MN,2014,V,1,31,555,I,255,0,10,Toulouse en marche !,A remplir,52
716,197,994,590,20,570,404,MN,2014,V,1,31,555,I,590,0,10,Toulouse en marche !,A remplir,1
717,198A,955,556,15,541,399,MN,2014,V,1,31,555,I,556,0,10,Toulouse en marche !,A remplir,5
718,223,1190,637,21,616,553,MN,2014,V,1,31,555,I,637,0,10,Toulouse en marche !,A remplir,7
719,226,987,505,6,499,482,MN,2014,V,1,31,555,I,505,0,10,Toulouse en marche !,A remplir,5
720,37,890,465,15,450,425,MN,2014,V,1,31,555,I,465,0,10,Toulouse en marche !,A remplir,8
721,70,1004,580,14,566,424,MN,2014,V,1,31,555,I,580,0,10,Toulouse en marche !,A remplir,8
722,74,1059,538,7,531,521,MN,2014,V,1,31,555,I,538,0,10,Toulouse en marche !,A remplir,4
723,178,970,371,10,361,599,MN,2014,V,1,31,555,I,371,0,10,Toulouse en marche !,A remplir,22
724,10A,1006,494,11,483,512,MN,2014,V,1,31,555,I,494,0,10,Toulouse en marche !,A remplir,5
725,29,1159,606,9,598,553,MN,2014,V,1,31,555,I,606,0,10,Toulouse en marche !,A remplir,8
726,67A,929,482,11,471,447,MN,2014,V,1,31,555,I,482,0,10,Toulouse en marche !,A remplir,7
727,100,1027,479,9,470,548,MN,2014,V,1,31,555,I,479,0,10,Toulouse en marche !,A remplir,18
728,114,1108,530,15,515,578,MN,2014,V,1,31,555,I,530,0,10,Toulouse en marche !,A remplir,8
729,126,911,511,9,502,400,MN,2014,V,1,31,555,I,511,0,10,Toulouse en marche !,A remplir,3
730,130,1083,574,13,561,509,MN,2014,V,1,31,555,I,574,0,10,Toulouse en marche !,A remplir,9
731,161,967,524,11,513,443,MN,2014,V,1,31,555,I,524,0,10,Toulouse en marche !,A remplir,4
732,174,1101,559,8,551,542,MN,2014,V,1,31,555,I,559,0,10,Toulouse en marche !,A remplir,16
733,202,1197,556,19,537,641,MN,2014,V,1,31,555,I,556,0,10,Toulouse en marche !,A remplir,9
734,216,1186,583,17,566,603,MN,2014,V,1,31,555,I,583,0,10,Toulouse en marche !,A remplir,13
735,216A,1122,459,20,439,663,MN,2014,V,1,31,555,I,459,0,10,Toulouse en marche !,A remplir,8
736,20,1041,656,16,640,385,MN,2014,V,1,31,555,I,656,0,10,Toulouse en marche !,A remplir,5
737,38,975,516,18,498,459,MN,2014,V,1,31,555,I,516,0,10,Toulouse en marche !,A remplir,8
738,43,1026,583,21,562,443,MN,2014,V,1,31,555,I,583,0,10,Toulouse en marche !,A remplir,13
739,133,983,556,15,541,427,MN,2014,V,1,31,555,I,556,0,10,Toulouse en marche !,A remplir,8
740,138A,951,606,17,589,345,MN,2014,V,1,31,555,I,606,0,10,Toulouse en marche !,A remplir,7
741,143,984,592,9,583,392,MN,2014,V,1,31,555,I,592,0,10,Toulouse en marche !,A remplir,5
742,160,1056,563,10,553,493,MN,2014,V,1,31,555,I,563,0,10,Toulouse en marche !,A remplir,12
743,180,755,275,2,273,480,MN,2014,V,1,31,555,I,275,0,10,Toulouse en marche !,A remplir,17
744,195B,1078,677,18,659,401,MN,2014,V,1,31,555,I,677,0,10,Toulouse en marche !,A remplir,10
745,196,1165,666,15,651,499,MN,2014,V,1,31,555,I,666,0,10,Toulouse en marche !,A remplir,4
746,217,1275,630,18,612,645,MN,2014,V,1,31,555,I,630,0,10,Toulouse en marche !,A remplir,14
747,28,1074,561,7,554,513,MN,2014,V,1,31,555,I,561,0,10,Jean-luc moudenc un nouvel elan pour toulouse,A remplir,244
748,41,975,548,11,537,427,MN,2014,V,1,31,555,I,548,0,10,Jean-luc moudenc un nouvel elan pour toulouse,A remplir,165
749,72,1046,510,5,505,536,MN,2014,V,1,31,555,I,510,0,10,Jean-luc moudenc un nouvel elan pour toulouse,A remplir,178
750,105,961,472,16,456,489,MN,2014,V,1,31,555,I,472,0,10,Jean-luc moudenc un nouvel elan pour toulouse,A remplir,164
751,109,1098,619,15,604,479,MN,2014,V,1,31,555,I,619,0,10,Jean-luc moudenc un nouvel elan pour toulouse,A remplir,276
752,117,1119,551,9,542,568,MN,2014,V,1,31,555,I,551,0,10,Jean-luc moudenc un nouvel elan pour toulouse,A remplir,194
753,121,1065,621,6,615,444,MN,2014,V,1,31,555,I,621,0,10,Jean-luc moudenc un nouvel elan pour toulouse,A remplir,308
754,171,1072,450,13,437,622,MN,2014,V,1,31,555,I,450,0,10,Jean-luc moudenc un nouvel elan pour toulouse,A remplir,165
755,174A,1093,484,9,475,609,MN,2014,V,1,31,555,I,484,0,10,Jean-luc moudenc un nouvel elan pour toulouse,A remplir,191
756,192,698,315,9,306,383,MN,2014,V,1,31,555,I,315,0,10,Jean-luc moudenc un nouvel elan pour toulouse,A remplir,114
757,194,863,405,15,390,458,MN,2014,V,1,31,555,I,405,0,10,Jean-luc moudenc un nouvel elan pour toulouse,A remplir,131
758,214,1312,659,16,643,653,MN,2014,V,1,31,555,I,659,0,10,Jean-luc moudenc un nouvel elan pour toulouse,A remplir,231
759,3,919,501,10,491,418,MN,2014,V,1,31,555,I,501,0,10,Jean-luc moudenc un nouvel elan pour toulouse,A remplir,240
760,44A,1061,529,19,510,532,MN,2014,V,1,31,555,I,529,0,10,Jean-luc moudenc un nouvel elan pour toulouse,A remplir,173
761,47,1034,588,11,577,446,MN,2014,V,1,31,555,I,588,0,10,Jean-luc moudenc un nouvel elan pour toulouse,A remplir,172
762,62,1049,498,12,486,551,MN,2014,V,1,31,555,I,498,0,10,Jean-luc moudenc un nouvel elan pour toulouse,A remplir,155
763,82,976,490,12,478,486,MN,2014,V,1,31,555,I,490,0,10,Jean-luc moudenc un nouvel elan pour toulouse,A remplir,194
764,86,1070,542,8,534,528,MN,2014,V,1,31,555,I,542,0,10,Jean-luc moudenc un nouvel elan pour toulouse,A remplir,146
765,127,908,537,9,528,371,MN,2014,V,1,31,555,I,537,0,10,Jean-luc moudenc un nouvel elan pour toulouse,A remplir,272
766,156,889,425,11,414,464,MN,2014,V,1,31,555,I,425,0,10,Jean-luc moudenc un nouvel elan pour toulouse,A remplir,154
767,159,1232,667,12,655,565,MN,2014,V,1,31,555,I,667,0,10,Jean-luc moudenc un nouvel elan pour toulouse,A remplir,207
768,169,953,362,11,351,591,MN,2014,V,1,31,555,I,362,0,10,Jean-luc moudenc un nouvel elan pour toulouse,A remplir,126
769,173,962,388,8,380,574,MN,2014,V,1,31,555,I,388,0,10,Jean-luc moudenc un nouvel elan pour toulouse,A remplir,129
770,203,848,421,16,405,427,MN,2014,V,1,31,555,I,421,0,10,Jean-luc moudenc un nouvel elan pour toulouse,A remplir,169
771,203B,1049,585,16,569,464,MN,2014,V,1,31,555,I,585,0,10,Jean-luc moudenc un nouvel elan pour toulouse,A remplir,260
772,18,1208,703,23,680,505,MN,2014,V,1,31,555,I,703,0,10,Jean-luc moudenc un nouvel elan pour toulouse,A remplir,265
773,48,1004,509,11,498,495,MN,2014,V,1,31,555,I,509,0,10,Jean-luc moudenc un nouvel elan pour toulouse,A remplir,126
774,57,882,517,18,499,365,MN,2014,V,1,31,555,I,517,0,10,Jean-luc moudenc un nouvel elan pour toulouse,A remplir,199
775,68,1002,582,23,559,420,MN,2014,V,1,31,555,I,582,0,10,Jean-luc moudenc un nouvel elan pour toulouse,A remplir,212
776,128,1114,576,22,554,538,MN,2014,V,1,31,555,I,576,0,10,Jean-luc moudenc un nouvel elan pour toulouse,A remplir,212
777,137,995,617,10,607,378,MN,2014,V,1,31,555,I,617,0,10,Jean-luc moudenc un nouvel elan pour toulouse,A remplir,294
778,144A,992,563,13,551,429,MN,2014,V,1,31,555,I,563,0,10,Jean-luc moudenc un nouvel elan pour toulouse,A remplir,237
779,157,1208,645,11,634,563,MN,2014,V,1,31,555,I,645,0,10,Jean-luc moudenc un nouvel elan pour toulouse,A remplir,231
780,166,1147,666,12,653,481,MN,2014,V,1,31,555,I,666,0,10,Jean-luc moudenc un nouvel elan pour toulouse,A remplir,216
781,195,811,443,7,436,368,MN,2014,V,1,31,555,I,443,0,10,Jean-luc moudenc un nouvel elan pour toulouse,A remplir,170
782,200A,1064,537,13,524,527,MN,2014,V,1,31,555,I,537,0,10,Jean-luc moudenc un nouvel elan pour toulouse,A remplir,249
783,203A,817,451,6,445,366,MN,2014,V,1,31,555,I,451,0,10,Jean-luc moudenc un nouvel elan pour toulouse,A remplir,206
784,35,1057,526,10,516,531,MN,2014,V,1,31,555,I,526,0,10,Jean-luc moudenc un nouvel elan pour toulouse,A remplir,113
785,45,1038,429,8,421,609,MN,2014,V,1,31,555,I,429,0,10,Jean-luc moudenc un nouvel elan pour toulouse,A remplir,119
786,61,859,467,16,451,392,MN,2014,V,1,31,555,I,467,0,10,Jean-luc moudenc un nouvel elan pour toulouse,A remplir,150
787,94,1110,641,11,630,469,MN,2014,V,1,31,555,I,641,0,10,Jean-luc moudenc un nouvel elan pour toulouse,A remplir,163
788,107,1019,581,8,573,438,MN,2014,V,1,31,555,I,581,0,10,Jean-luc moudenc un nouvel elan pour toulouse,A remplir,300
789,110,918,502,13,489,416,MN,2014,V,1,31,555,I,502,0,10,Jean-luc moudenc un nouvel elan pour toulouse,A remplir,234
790,134A,1406,745,22,723,661,MN,2014,V,1,31,555,I,745,0,10,Jean-luc moudenc un nouvel elan pour toulouse,A remplir,317
791,146,833,440,3,437,393,MN,2014,V,1,31,555,I,440,0,10,Jean-luc moudenc un nouvel elan pour toulouse,A remplir,164
792,186,1299,322,18,304,977,MN,2014,V,1,31,555,I,322,0,10,Jean-luc moudenc un nouvel elan pour toulouse,A remplir,98
793,195A,1090,474,13,461,616,MN,2014,V,1,31,555,I,474,0,10,Jean-luc moudenc un nouvel elan pour toulouse,A remplir,169
794,16,947,558,10,548,389,MN,2014,V,1,31,555,I,558,0,10,Jean-luc moudenc un nouvel elan pour toulouse,A remplir,232
795,39A,938,525,28,497,413,MN,2014,V,1,31,555,I,525,0,10,Jean-luc moudenc un nouvel elan pour toulouse,A remplir,143
796,85,994,452,13,439,542,MN,2014,V,1,31,555,I,452,0,10,Jean-luc moudenc un nouvel elan pour toulouse,A remplir,167
797,87,1204,619,8,612,585,MN,2014,V,1,31,555,I,619,0,10,Jean-luc moudenc un nouvel elan pour toulouse,A remplir,188
798,93B,1235,656,16,640,579,MN,2014,V,1,31,555,I,656,0,10,Jean-luc moudenc un nouvel elan pour toulouse,A remplir,244
799,101,1126,627,10,617,499,MN,2014,V,1,31,555,I,627,0,10,Jean-luc moudenc un nouvel elan pour toulouse,A remplir,169
800,104,1042,609,21,588,433,MN,2014,V,1,31,555,I,609,0,10,Jean-luc moudenc un nouvel elan pour toulouse,A remplir,220
801,112,841,429,10,419,412,MN,2014,V,1,31,555,I,429,0,10,Jean-luc moudenc un nouvel elan pour toulouse,A remplir,150
802,148,830,418,14,404,412,MN,2014,V,1,31,555,I,418,0,10,Jean-luc moudenc un nouvel elan pour toulouse,A remplir,141
803,207,1141,602,18,584,539,MN,2014,V,1,31,555,I,602,0,10,Jean-luc moudenc un nouvel elan pour toulouse,A remplir,200
804,210,1252,597,16,581,655,MN,2014,V,1,31,555,I,597,0,10,Jean-luc moudenc un nouvel elan pour toulouse,A remplir,214
805,10,979,521,13,508,458,MN,2014,V,1,31,555,I,521,0,10,Jean-luc moudenc un nouvel elan pour toulouse,A remplir,206
806,77,976,544,9,535,432,MN,2014,V,1,31,555,I,544,0,10,Jean-luc moudenc un nouvel elan pour toulouse,A remplir,204
807,91,1000,523,15,508,477,MN,2014,V,1,31,555,I,523,0,10,Jean-luc moudenc un nouvel elan pour toulouse,A remplir,168
808,132,1073,553,5,548,520,MN,2014,V,1,31,555,I,553,0,10,Jean-luc moudenc un nouvel elan pour toulouse,A remplir,250
809,189,832,311,8,303,521,MN,2014,V,1,31,555,I,311,0,10,Jean-luc moudenc un nouvel elan pour toulouse,A remplir,97
810,193A,795,360,9,351,435,MN,2014,V,1,31,555,I,360,0,10,Jean-luc moudenc un nouvel elan pour toulouse,A remplir,132
811,209,1102,507,22,485,595,MN,2014,V,1,31,555,I,507,0,10,Jean-luc moudenc un nouvel elan pour toulouse,A remplir,175
812,212,442,187,4,183,255,MN,2014,V,1,31,555,I,187,0,10,Jean-luc moudenc un nouvel elan pour toulouse,A remplir,74
813,4,956,571,10,561,385,MN,2014,V,1,31,555,I,571,0,10,Jean-luc moudenc un nouvel elan pour toulouse,A remplir,318
814,19,1084,637,8,631,447,MN,2014,V,1,31,555,I,637,0,10,Jean-luc moudenc un nouvel elan pour toulouse,A remplir,292
815,30,992,554,7,547,438,MN,2014,V,1,31,555,I,554,0,10,Jean-luc moudenc un nouvel elan pour toulouse,A remplir,295
816,56,1025,487,8,479,538,MN,2014,V,1,31,555,I,487,0,10,Jean-luc moudenc un nouvel elan pour toulouse,A remplir,180
817,84,1173,642,7,635,531,MN,2014,V,1,31,555,I,642,0,10,Jean-luc moudenc un nouvel elan pour toulouse,A remplir,248
818,93A,1276,661,14,647,615,MN,2014,V,1,31,555,I,661,0,10,Jean-luc moudenc un nouvel elan pour toulouse,A remplir,214
819,144,991,611,13,598,380,MN,2014,V,1,31,555,I,611,0,10,Jean-luc moudenc un nouvel elan pour toulouse,A remplir,287
820,22,1086,605,16,589,481,MN,2014,V,1,31,555,I,605,0,10,Jean-luc moudenc un nouvel elan pour toulouse,A remplir,284
821,25,1083,547,7,540,536,MN,2014,V,1,31,555,I,547,0,10,Jean-luc moudenc un nouvel elan pour toulouse,A remplir,150
822,73,1069,531,13,518,538,MN,2014,V,1,31,555,I,531,0,10,Jean-luc moudenc un nouvel elan pour toulouse,A remplir,167
823,99,933,486,11,475,447,MN,2014,V,1,31,555,I,486,0,10,Jean-luc moudenc un nouvel elan pour toulouse,A remplir,139
824,103,871,459,18,441,412,MN,2014,V,1,31,555,I,459,0,10,Jean-luc moudenc un nouvel elan pour toulouse,A remplir,144
825,140,935,559,9,550,376,MN,2014,V,1,31,555,I,559,0,10,Jean-luc moudenc un nouvel elan pour toulouse,A remplir,290
826,150,1022,574,6,568,448,MN,2014,V,1,31,555,I,574,0,10,Jean-luc moudenc un nouvel elan pour toulouse,A remplir,153
827,168,934,464,17,447,470,MN,2014,V,1,31,555,I,464,0,10,Jean-luc moudenc un nouvel elan pour toulouse,A remplir,144
828,22A,1047,587,16,571,460,MN,2014,V,1,31,555,I,587,0,10,Jean-luc moudenc un nouvel elan pour toulouse,A remplir,239
829,52,1066,539,12,527,527,MN,2014,V,1,31,555,I,539,0,10,Jean-luc moudenc un nouvel elan pour toulouse,A remplir,176
830,66,862,474,16,458,388,MN,2014,V,1,31,555,I,474,0,10,Jean-luc moudenc un nouvel elan pour toulouse,A remplir,179
831,96,978,542,17,525,436,MN,2014,V,1,31,555,I,542,0,10,Jean-luc moudenc un nouvel elan pour toulouse,A remplir,160
832,118,1142,631,12,619,511,MN,2014,V,1,31,555,I,631,0,10,Jean-luc moudenc un nouvel elan pour toulouse,A remplir,307
833,139,965,529,11,518,436,MN,2014,V,1,31,555,I,529,0,10,Jean-luc moudenc un nouvel elan pour toulouse,A remplir,234
834,141,957,569,8,561,388,MN,2014,V,1,31,555,I,569,0,10,Jean-luc moudenc un nouvel elan pour toulouse,A remplir,272
835,164,1183,491,16,475,692,MN,2014,V,1,31,555,I,491,0,10,Jean-luc moudenc un nouvel elan pour toulouse,A remplir,135
836,181,931,370,12,358,561,MN,2014,V,1,31,555,I,370,0,10,Jean-luc moudenc un nouvel elan pour toulouse,A remplir,130
837,211A,1286,623,28,595,663,MN,2014,V,1,31,555,I,623,0,10,Jean-luc moudenc un nouvel elan pour toulouse,A remplir,208
838,2,931,505,12,493,426,MN,2014,V,1,31,555,I,505,0,10,Jean-luc moudenc un nouvel elan pour toulouse,A remplir,201
839,9,941,528,3,525,413,MN,2014,V,1,31,555,I,528,0,10,Jean-luc moudenc un nouvel elan pour toulouse,A remplir,202
840,40,1276,595,11,584,681,MN,2014,V,1,31,555,I,595,0,10,Jean-luc moudenc un nouvel elan pour toulouse,A remplir,206
841,59,1038,581,10,571,457,MN,2014,V,1,31,555,I,581,0,10,Jean-luc moudenc un nouvel elan pour toulouse,A remplir,199
842,88,1122,596,12,584,526,MN,2014,V,1,31,555,I,596,0,10,Jean-luc moudenc un nouvel elan pour toulouse,A remplir,194
843,106,962,481,17,465,481,MN,2014,V,1,31,555,I,481,0,10,Jean-luc moudenc un nouvel elan pour toulouse,A remplir,144
844,120,1058,610,18,592,448,MN,2014,V,1,31,555,I,610,0,10,Jean-luc moudenc un nouvel elan pour toulouse,A remplir,312
845,145,1015,549,14,535,466,MN,2014,V,1,31,555,I,549,0,10,Jean-luc moudenc un nouvel elan pour toulouse,A remplir,213
846,149,1123,622,12,610,501,MN,2014,V,1,31,555,I,622,0,10,Jean-luc moudenc un nouvel elan pour toulouse,A remplir,186
847,201B,1032,580,19,561,452,MN,2014,V,1,31,555,I,580,0,10,Jean-luc moudenc un nouvel elan pour toulouse,A remplir,278
848,206,1087,549,20,529,538,MN,2014,V,1,31,555,I,549,0,10,Jean-luc moudenc un nouvel elan pour toulouse,A remplir,181
849,55,1082,614,14,600,468,MN,2014,V,1,31,555,I,614,0,10,Jean-luc moudenc un nouvel elan pour toulouse,A remplir,199
850,83,1176,712,10,702,464,MN,2014,V,1,31,555,I,712,0,10,Jean-luc moudenc un nouvel elan pour toulouse,A remplir,294
851,136,730,449,8,442,281,MN,2014,V,1,31,555,I,449,0,10,Jean-luc moudenc un nouvel elan pour toulouse,A remplir,234
852,158,1155,634,10,624,521,MN,2014,V,1,31,555,I,634,0,10,Jean-luc moudenc un nouvel elan pour toulouse,A remplir,191
853,162,1033,534,12,522,499,MN,2014,V,1,31,555,I,534,0,10,Jean-luc moudenc un nouvel elan pour toulouse,A remplir,176
854,170,819,446,8,438,373,MN,2014,V,1,31,555,I,446,0,10,Jean-luc moudenc un nouvel elan pour toulouse,A remplir,165
855,172,870,533,11,522,337,MN,2014,V,1,31,555,I,533,0,10,Jean-luc moudenc un nouvel elan pour toulouse,A remplir,246
856,222,1321,665,21,644,656,MN,2014,V,1,31,555,I,665,0,10,Jean-luc moudenc un nouvel elan pour toulouse,A remplir,227
857,7,928,450,9,441,478,MN,2014,V,1,31,555,I,450,0,10,Jean-luc moudenc un nouvel elan pour toulouse,A remplir,162
858,11,1115,633,14,620,482,MN,2014,V,1,31,555,I,633,0,10,Jean-luc moudenc un nouvel elan pour toulouse,A remplir,282
859,21,944,561,12,549,383,MN,2014,V,1,31,555,I,561,0,10,Jean-luc moudenc un nouvel elan pour toulouse,A remplir,300
860,53,1067,569,13,556,498,MN,2014,V,1,31,555,I,569,0,10,Jean-luc moudenc un nouvel elan pour toulouse,A remplir,185
861,122,1038,637,5,632,401,MN,2014,V,1,31,555,I,637,0,10,Jean-luc moudenc un nouvel elan pour toulouse,A remplir,394
862,124,1082,650,16,634,432,MN,2014,V,1,31,555,I,650,0,10,Jean-luc moudenc un nouvel elan pour toulouse,A remplir,355
863,129,990,483,16,467,507,MN,2014,V,1,31,555,I,483,0,10,Jean-luc moudenc un nouvel elan pour toulouse,A remplir,181
864,134,875,516,10,506,359,MN,2014,V,1,31,555,I,516,0,10,Jean-luc moudenc un nouvel elan pour toulouse,A remplir,297
865,135,1027,636,7,630,391,MN,2014,V,1,31,555,I,636,0,10,Jean-luc moudenc un nouvel elan pour toulouse,A remplir,329
866,175,995,320,11,309,675,MN,2014,V,1,31,555,I,320,0,10,Jean-luc moudenc un nouvel elan pour toulouse,A remplir,109
867,177,1084,439,24,415,645,MN,2014,V,1,31,555,I,439,0,10,Jean-luc moudenc un nouvel elan pour toulouse,A remplir,171
868,193,650,268,4,264,382,MN,2014,V,1,31,555,I,268,0,10,Jean-luc moudenc un nouvel elan pour toulouse,A remplir,100
869,199,503,252,4,248,251,MN,2014,V,1,31,555,I,252,0,10,Jean-luc moudenc un nouvel elan pour toulouse,A remplir,121
870,213,1101,583,17,566,518,MN,2014,V,1,31,555,I,583,0,10,Jean-luc moudenc un nouvel elan pour toulouse,A remplir,216
871,219,1138,614,10,604,524,MN,2014,V,1,31,555,I,614,0,10,Jean-luc moudenc un nouvel elan pour toulouse,A remplir,210
872,12,1116,608,12,596,508,MN,2014,V,1,31,555,I,608,0,10,Jean-luc moudenc un nouvel elan pour toulouse,A remplir,258
873,31,1020,561,8,553,459,MN,2014,V,1,31,555,I,561,0,10,Jean-luc moudenc un nouvel elan pour toulouse,A remplir,331
874,36,806,435,14,421,371,MN,2014,V,1,31,555,I,435,0,10,Jean-luc moudenc un nouvel elan pour toulouse,A remplir,164
875,46,986,558,11,547,428,MN,2014,V,1,31,555,I,558,0,10,Jean-luc moudenc un nouvel elan pour toulouse,A remplir,185
876,81,1177,499,16,483,678,MN,2014,V,1,31,555,I,499,0,10,Jean-luc moudenc un nouvel elan pour toulouse,A remplir,136
877,142,890,459,6,453,431,MN,2014,V,1,31,555,I,459,0,10,Jean-luc moudenc un nouvel elan pour toulouse,A remplir,216
878,152,944,355,14,341,589,MN,2014,V,1,31,555,I,355,0,10,Jean-luc moudenc un nouvel elan pour toulouse,A remplir,107
879,167,995,543,9,534,452,MN,2014,V,1,31,555,I,543,0,10,Jean-luc moudenc un nouvel elan pour toulouse,A remplir,185
880,190,1008,247,9,238,761,MN,2014,V,1,31,555,I,247,0,10,Jean-luc moudenc un nouvel elan pour toulouse,A remplir,77
881,225,838,451,16,435,387,MN,2014,V,1,31,555,I,451,0,10,Jean-luc moudenc un nouvel elan pour toulouse,A remplir,132
882,49,759,440,8,432,319,MN,2014,V,1,31,555,I,440,0,10,Jean-luc moudenc un nouvel elan pour toulouse,A remplir,118
883,50,977,533,16,517,444,MN,2014,V,1,31,555,I,533,0,10,Jean-luc moudenc un nouvel elan pour toulouse,A remplir,156
884,60,1164,611,25,586,553,MN,2014,V,1,31,555,I,611,0,10,Jean-luc moudenc un nouvel elan pour toulouse,A remplir,180
885,108A,939,523,13,510,416,MN,2014,V,1,31,555,I,523,0,10,Jean-luc moudenc un nouvel elan pour toulouse,A remplir,154
886,125,957,575,11,564,382,MN,2014,V,1,31,555,I,575,0,10,Jean-luc moudenc un nouvel elan pour toulouse,A remplir,290
887,182,794,435,10,425,359,MN,2014,V,1,31,555,I,435,0,10,Jean-luc moudenc un nouvel elan pour toulouse,A remplir,149
888,215,1373,629,18,611,744,MN,2014,V,1,31,555,I,629,0,10,Jean-luc moudenc un nouvel elan pour toulouse,A remplir,211
889,1,1100,541,10,532,559,MN,2014,V,1,31,555,I,541,0,10,Jean-luc moudenc un nouvel elan pour toulouse,A remplir,215
890,44,971,558,16,542,413,MN,2014,V,1,31,555,I,558,0,10,Jean-luc moudenc un nouvel elan pour toulouse,A remplir,177
891,49A,856,513,8,505,343,MN,2014,V,1,31,555,I,513,0,10,Jean-luc moudenc un nouvel elan pour toulouse,A remplir,192
892,165A,982,609,11,598,373,MN,2014,V,1,31,555,I,609,0,10,Jean-luc moudenc un nouvel elan pour toulouse,A remplir,251
893,200,1192,654,15,639,538,MN,2014,V,1,31,555,I,654,0,10,Jean-luc moudenc un nouvel elan pour toulouse,A remplir,342
894,5,772,439,10,429,333,MN,2014,V,1,31,555,I,439,0,10,Jean-luc moudenc un nouvel elan pour toulouse,A remplir,214
895,24,1061,543,8,535,518,MN,2014,V,1,31,555,I,543,0,10,Jean-luc moudenc un nouvel elan pour toulouse,A remplir,179
896,25A,1002,518,11,507,484,MN,2014,V,1,31,555,I,518,0,10,Jean-luc moudenc un nouvel elan pour toulouse,A remplir,166
897,51,1230,659,18,641,571,MN,2014,V,1,31,555,I,659,0,10,Jean-luc moudenc un nouvel elan pour toulouse,A remplir,212
898,71,941,513,10,504,428,MN,2014,V,1,31,555,I,513,0,10,Jean-luc moudenc un nouvel elan pour toulouse,A remplir,156
899,78,1006,624,19,605,382,MN,2014,V,1,31,555,I,624,0,10,Jean-luc moudenc un nouvel elan pour toulouse,A remplir,252
900,79,915,498,6,491,417,MN,2014,V,1,31,555,I,498,0,10,Jean-luc moudenc un nouvel elan pour toulouse,A remplir,168
901,80,1173,553,9,544,620,MN,2014,V,1,31,555,I,553,0,10,Jean-luc moudenc un nouvel elan pour toulouse,A remplir,194
902,97,1084,564,10,553,520,MN,2014,V,1,31,555,I,564,0,10,Jean-luc moudenc un nouvel elan pour toulouse,A remplir,162
903,184,1151,355,10,345,796,MN,2014,V,1,31,555,I,355,0,10,Jean-luc moudenc un nouvel elan pour toulouse,A remplir,119
904,188,1220,497,20,477,723,MN,2014,V,1,31,555,I,497,0,10,Jean-luc moudenc un nouvel elan pour toulouse,A remplir,159
905,8,891,480,13,467,411,MN,2014,V,1,31,555,I,480,0,10,Jean-luc moudenc un nouvel elan pour toulouse,A remplir,144
906,14,1014,595,6,589,419,MN,2014,V,1,31,555,I,595,0,10,Jean-luc moudenc un nouvel elan pour toulouse,A remplir,239
907,34,953,496,10,486,457,MN,2014,V,1,31,555,I,496,0,10,Jean-luc moudenc un nouvel elan pour toulouse,A remplir,151
908,39,1160,603,12,591,557,MN,2014,V,1,31,555,I,603,0,10,Jean-luc moudenc un nouvel elan pour toulouse,A remplir,186
909,63,806,314,6,308,492,MN,2014,V,1,31,555,I,314,0,10,Jean-luc moudenc un nouvel elan pour toulouse,A remplir,90
910,124A,982,582,15,567,400,MN,2014,V,1,31,555,I,582,0,10,Jean-luc moudenc un nouvel elan pour toulouse,A remplir,309
911,205,1184,651,18,633,533,MN,2014,V,1,31,555,I,651,0,10,Jean-luc moudenc un nouvel elan pour toulouse,A remplir,181
912,6,1098,531,11,520,567,MN,2014,V,1,31,555,I,531,0,10,Jean-luc moudenc un nouvel elan pour toulouse,A remplir,189
913,23,1205,614,7,607,591,MN,2014,V,1,31,555,I,614,0,10,Jean-luc moudenc un nouvel elan pour toulouse,A remplir,168
914,64,1233,675,22,653,558,MN,2014,V,1,31,555,I,675,0,10,Jean-luc moudenc un nouvel elan pour toulouse,A remplir,179
915,75,949,456,15,441,493,MN,2014,V,1,31,555,I,456,0,10,Jean-luc moudenc un nouvel elan pour toulouse,A remplir,86
916,76,1007,517,7,510,490,MN,2014,V,1,31,555,I,517,0,10,Jean-luc moudenc un nouvel elan pour toulouse,A remplir,156
917,111,956,511,10,501,445,MN,2014,V,1,31,555,I,511,0,10,Jean-luc moudenc un nouvel elan pour toulouse,A remplir,205
918,123,1134,589,8,581,545,MN,2014,V,1,31,555,I,589,0,10,Jean-luc moudenc un nouvel elan pour toulouse,A remplir,239
919,131,1051,602,12,590,449,MN,2014,V,1,31,555,I,602,0,10,Jean-luc moudenc un nouvel elan pour toulouse,A remplir,276
920,154,809,278,13,265,531,MN,2014,V,1,31,555,I,278,0,10,Jean-luc moudenc un nouvel elan pour toulouse,A remplir,89
921,179,709,357,9,348,352,MN,2014,V,1,31,555,I,357,0,10,Jean-luc moudenc un nouvel elan pour toulouse,A remplir,100
922,211,1377,732,18,714,645,MN,2014,V,1,31,555,I,732,0,10,Jean-luc moudenc un nouvel elan pour toulouse,A remplir,239
923,13,1041,588,11,577,453,MN,2014,V,1,31,555,I,588,0,10,Jean-luc moudenc un nouvel elan pour toulouse,A remplir,162
924,15,1078,643,10,633,435,MN,2014,V,1,31,555,I,643,0,10,Jean-luc moudenc un nouvel elan pour toulouse,A remplir,228
925,27,1122,647,10,637,475,MN,2014,V,1,31,555,I,647,0,10,Jean-luc moudenc un nouvel elan pour toulouse,A remplir,321
926,36A,1124,605,14,591,519,MN,2014,V,1,31,555,I,605,0,10,Jean-luc moudenc un nouvel elan pour toulouse,A remplir,156
927,56A,894,469,9,460,425,MN,2014,V,1,31,555,I,469,0,10,Jean-luc moudenc un nouvel elan pour toulouse,A remplir,175
928,69,1090,574,12,562,516,MN,2014,V,1,31,555,I,574,0,10,Jean-luc moudenc un nouvel elan pour toulouse,A remplir,200
929,113,1030,455,18,437,575,MN,2014,V,1,31,555,I,455,0,10,Jean-luc moudenc un nouvel elan pour toulouse,A remplir,141
930,147,1006,591,11,580,415,MN,2014,V,1,31,555,I,591,0,10,Jean-luc moudenc un nouvel elan pour toulouse,A remplir,202
931,165,1463,797,24,773,666,MN,2014,V,1,31,555,I,797,0,10,Jean-luc moudenc un nouvel elan pour toulouse,A remplir,228
932,201A,1154,711,21,690,443,MN,2014,V,1,31,555,I,711,0,10,Jean-luc moudenc un nouvel elan pour toulouse,A remplir,410
933,204,1153,587,18,569,566,MN,2014,V,1,31,555,I,587,0,10,Jean-luc moudenc un nouvel elan pour toulouse,A remplir,160
934,218,1264,701,15,686,563,MN,2014,V,1,31,555,I,701,0,10,Jean-luc moudenc un nouvel elan pour toulouse,A remplir,244
935,220,1242,685,19,666,557,MN,2014,V,1,31,555,I,685,0,10,Jean-luc moudenc un nouvel elan pour toulouse,A remplir,260
936,42,962,516,14,502,446,MN,2014,V,1,31,555,I,516,0,10,Jean-luc moudenc un nouvel elan pour toulouse,A remplir,168
937,58,1199,536,13,523,663,MN,2014,V,1,31,555,I,536,0,10,Jean-luc moudenc un nouvel elan pour toulouse,A remplir,174
938,95,1039,530,11,519,509,MN,2014,V,1,31,555,I,530,0,10,Jean-luc moudenc un nouvel elan pour toulouse,A remplir,168
939,116,1060,541,13,528,519,MN,2014,V,1,31,555,I,541,0,10,Jean-luc moudenc un nouvel elan pour toulouse,A remplir,189
940,151,983,544,9,535,439,MN,2014,V,1,31,555,I,544,0,10,Jean-luc moudenc un nouvel elan pour toulouse,A remplir,154
941,155,726,257,7,250,469,MN,2014,V,1,31,555,I,257,0,10,Jean-luc moudenc un nouvel elan pour toulouse,A remplir,63
942,198B,1072,625,17,608,447,MN,2014,V,1,31,555,I,625,0,10,Jean-luc moudenc un nouvel elan pour toulouse,A remplir,248
943,201,1015,630,10,620,385,MN,2014,V,1,31,555,I,630,0,10,Jean-luc moudenc un nouvel elan pour toulouse,A remplir,370
944,224,780,412,11,401,368,MN,2014,V,1,31,555,I,412,0,10,Jean-luc moudenc un nouvel elan pour toulouse,A remplir,137
945,17,940,535,10,525,405,MN,2014,V,1,31,555,I,535,0,10,Jean-luc moudenc un nouvel elan pour toulouse,A remplir,232
946,65,1142,646,19,627,496,MN,2014,V,1,31,555,I,646,0,10,Jean-luc moudenc un nouvel elan pour toulouse,A remplir,213
947,67,983,550,21,529,433,MN,2014,V,1,31,555,I,550,0,10,Jean-luc moudenc un nouvel elan pour toulouse,A remplir,189
948,102,739,369,8,361,370,MN,2014,V,1,31,555,I,369,0,10,Jean-luc moudenc un nouvel elan pour toulouse,A remplir,120
949,113A,976,526,13,513,450,MN,2014,V,1,31,555,I,526,0,10,Jean-luc moudenc un nouvel elan pour toulouse,A remplir,186
950,119,970,576,9,567,394,MN,2014,V,1,31,555,I,576,0,10,Jean-luc moudenc un nouvel elan pour toulouse,A remplir,351
951,191A,925,327,20,307,598,MN,2014,V,1,31,555,I,327,0,10,Jean-luc moudenc un nouvel elan pour toulouse,A remplir,89
952,198,1241,700,19,681,541,MN,2014,V,1,31,555,I,700,0,10,Jean-luc moudenc un nouvel elan pour toulouse,A remplir,256
953,208,1196,696,27,669,500,MN,2014,V,1,31,555,I,696,0,10,Jean-luc moudenc un nouvel elan pour toulouse,A remplir,238
954,32,848,516,8,508,332,MN,2014,V,1,31,555,I,516,0,10,Jean-luc moudenc un nouvel elan pour toulouse,A remplir,316
955,33,1059,631,17,614,428,MN,2014,V,1,31,555,I,631,0,10,Jean-luc moudenc un nouvel elan pour toulouse,A remplir,159
956,44B,805,394,16,378,411,MN,2014,V,1,31,555,I,394,0,10,Jean-luc moudenc un nouvel elan pour toulouse,A remplir,130
957,54,991,513,15,497,478,MN,2014,V,1,31,555,I,513,0,10,Jean-luc moudenc un nouvel elan pour toulouse,A remplir,161
958,92,1184,581,19,562,603,MN,2014,V,1,31,555,I,581,0,10,Jean-luc moudenc un nouvel elan pour toulouse,A remplir,185
959,93,1248,671,22,649,577,MN,2014,V,1,31,555,I,671,0,10,Jean-luc moudenc un nouvel elan pour toulouse,A remplir,222
960,108,1029,598,16,582,431,MN,2014,V,1,31,555,I,598,0,10,Jean-luc moudenc un nouvel elan pour toulouse,A remplir,256
961,138,889,558,15,543,331,MN,2014,V,1,31,555,I,558,0,10,Jean-luc moudenc un nouvel elan pour toulouse,A remplir,290
962,153,706,148,5,143,558,MN,2014,V,1,31,555,I,148,0,10,Jean-luc moudenc un nouvel elan pour toulouse,A remplir,44
963,163,1016,466,7,460,550,MN,2014,V,1,31,555,I,466,0,10,Jean-luc moudenc un nouvel elan pour toulouse,A remplir,140
964,191,1000,255,12,243,745,MN,2014,V,1,31,555,I,255,0,10,Jean-luc moudenc un nouvel elan pour toulouse,A remplir,68
965,197,994,590,20,570,404,MN,2014,V,1,31,555,I,590,0,10,Jean-luc moudenc un nouvel elan pour toulouse,A remplir,238
966,198A,955,556,15,541,399,MN,2014,V,1,31,555,I,556,0,10,Jean-luc moudenc un nouvel elan pour toulouse,A remplir,218
967,223,1190,637,21,616,553,MN,2014,V,1,31,555,I,637,0,10,Jean-luc moudenc un nouvel elan pour toulouse,A remplir,238
968,226,987,505,6,499,482,MN,2014,V,1,31,555,I,505,0,10,Jean-luc moudenc un nouvel elan pour toulouse,A remplir,167
969,37,890,465,15,450,425,MN,2014,V,1,31,555,I,465,0,10,Jean-luc moudenc un nouvel elan pour toulouse,A remplir,141
970,70,1004,580,14,566,424,MN,2014,V,1,31,555,I,580,0,10,Jean-luc moudenc un nouvel elan pour toulouse,A remplir,235
971,74,1059,538,7,531,521,MN,2014,V,1,31,555,I,538,0,10,Jean-luc moudenc un nouvel elan pour toulouse,A remplir,271
972,178,970,371,10,361,599,MN,2014,V,1,31,555,I,371,0,10,Jean-luc moudenc un nouvel elan pour toulouse,A remplir,122
973,10A,1006,494,11,483,512,MN,2014,V,1,31,555,I,494,0,10,Jean-luc moudenc un nouvel elan pour toulouse,A remplir,158
974,29,1159,606,9,598,553,MN,2014,V,1,31,555,I,606,0,10,Jean-luc moudenc un nouvel elan pour toulouse,A remplir,263
975,67A,929,482,11,471,447,MN,2014,V,1,31,555,I,482,0,10,Jean-luc moudenc un nouvel elan pour toulouse,A remplir,162
976,100,1027,479,9,470,548,MN,2014,V,1,31,555,I,479,0,10,Jean-luc moudenc un nouvel elan pour toulouse,A remplir,111
977,114,1108,530,15,515,578,MN,2014,V,1,31,555,I,530,0,10,Jean-luc moudenc un nouvel elan pour toulouse,A remplir,185
978,126,911,511,9,502,400,MN,2014,V,1,31,555,I,511,0,10,Jean-luc moudenc un nouvel elan pour toulouse,A remplir,220
979,130,1083,574,13,561,509,MN,2014,V,1,31,555,I,574,0,10,Jean-luc moudenc un nouvel elan pour toulouse,A remplir,231
980,161,967,524,11,513,443,MN,2014,V,1,31,555,I,524,0,10,Jean-luc moudenc un nouvel elan pour toulouse,A remplir,177
981,174,1101,559,8,551,542,MN,2014,V,1,31,555,I,559,0,10,Jean-luc moudenc un nouvel elan pour toulouse,A remplir,191
982,202,1197,556,19,537,641,MN,2014,V,1,31,555,I,556,0,10,Jean-luc moudenc un nouvel elan pour toulouse,A remplir,184
983,216,1186,583,17,566,603,MN,2014,V,1,31,555,I,583,0,10,Jean-luc moudenc un nouvel elan pour toulouse,A remplir,187
984,216A,1122,459,20,439,663,MN,2014,V,1,31,555,I,459,0,10,Jean-luc moudenc un nouvel elan pour toulouse,A remplir,163
985,20,1041,656,16,640,385,MN,2014,V,1,31,555,I,656,0,10,Jean-luc moudenc un nouvel elan pour toulouse,A remplir,302
986,38,975,516,18,498,459,MN,2014,V,1,31,555,I,516,0,10,Jean-luc moudenc un nouvel elan pour toulouse,A remplir,132
987,43,1026,583,21,562,443,MN,2014,V,1,31,555,I,583,0,10,Jean-luc moudenc un nouvel elan pour toulouse,A remplir,214
988,133,983,556,15,541,427,MN,2014,V,1,31,555,I,556,0,10,Jean-luc moudenc un nouvel elan pour toulouse,A remplir,237
989,138A,951,606,17,589,345,MN,2014,V,1,31,555,I,606,0,10,Jean-luc moudenc un nouvel elan pour toulouse,A remplir,273
990,143,984,592,9,583,392,MN,2014,V,1,31,555,I,592,0,10,Jean-luc moudenc un nouvel elan pour toulouse,A remplir,301
991,160,1056,563,10,553,493,MN,2014,V,1,31,555,I,563,0,10,Jean-luc moudenc un nouvel elan pour toulouse,A remplir,196
992,180,755,275,2,273,480,MN,2014,V,1,31,555,I,275,0,10,Jean-luc moudenc un nouvel elan pour toulouse,A remplir,101
993,195B,1078,677,18,659,401,MN,2014,V,1,31,555,I,677,0,10,Jean-luc moudenc un nouvel elan pour toulouse,A remplir,264
994,196,1165,666,15,651,499,MN,2014,V,1,31,555,I,666,0,10,Jean-luc moudenc un nouvel elan pour toulouse,A remplir,249
995,217,1275,630,18,612,645,MN,2014,V,1,31,555,I,630,0,10,Jean-luc moudenc un nouvel elan pour toulouse,A remplir,206
996,28,1074,561,7,554,513,MN,2014,V,1,31,555,I,561,0,10,Lutte ouvriere faire entendre le camp des travailleurs,A remplir,1
997,41,975,548,11,537,427,MN,2014,V,1,31,555,I,548,0,10,Lutte ouvriere faire entendre le camp des travailleurs,A remplir,4
998,72,1046,510,5,505,536,MN,2014,V,1,31,555,I,510,0,10,Lutte ouvriere faire entendre le camp des travailleurs,A remplir,2
999,105,961,472,16,456,489,MN,2014,V,1,31,555,I,472,0,10,Lutte ouvriere faire entendre le camp des travailleurs,A remplir,7
1000,109,1098,619,15,604,479,MN,2014,V,1,31,555,I,619,0,10,Lutte ouvriere faire entendre le camp des travailleurs,A remplir,7
1001,117,1119,551,9,542,568,MN,2014,V,1,31,555,I,551,0,10,Lutte ouvriere faire entendre le camp des travailleurs,A remplir,6
1002,121,1065,621,6,615,444,MN,2014,V,1,31,555,I,621,0,10,Lutte ouvriere faire entendre le camp des travailleurs,A remplir,4
1003,171,1072,450,13,437,622,MN,2014,V,1,31,555,I,450,0,10,Lutte ouvriere faire entendre le camp des travailleurs,A remplir,5
1004,174A,1093,484,9,475,609,MN,2014,V,1,31,555,I,484,0,10,Lutte ouvriere faire entendre le camp des travailleurs,A remplir,5
1005,192,698,315,9,306,383,MN,2014,V,1,31,555,I,315,0,10,Lutte ouvriere faire entendre le camp des travailleurs,A remplir,3
1006,194,863,405,15,390,458,MN,2014,V,1,31,555,I,405,0,10,Lutte ouvriere faire entendre le camp des travailleurs,A remplir,2
1007,214,1312,659,16,643,653,MN,2014,V,1,31,555,I,659,0,10,Lutte ouvriere faire entendre le camp des travailleurs,A remplir,8
1008,3,919,501,10,491,418,MN,2014,V,1,31,555,I,501,0,10,Lutte ouvriere faire entendre le camp des travailleurs,A remplir,1
1009,44A,1061,529,19,510,532,MN,2014,V,1,31,555,I,529,0,10,Lutte ouvriere faire entendre le camp des travailleurs,A remplir,2
1010,47,1034,588,11,577,446,MN,2014,V,1,31,555,I,588,0,10,Lutte ouvriere faire entendre le camp des travailleurs,A remplir,6
1011,62,1049,498,12,486,551,MN,2014,V,1,31,555,I,498,0,10,Lutte ouvriere faire entendre le camp des travailleurs,A remplir,1
1012,82,976,490,12,478,486,MN,2014,V,1,31,555,I,490,0,10,Lutte ouvriere faire entendre le camp des travailleurs,A remplir,3
1013,86,1070,542,8,534,528,MN,2014,V,1,31,555,I,542,0,10,Lutte ouvriere faire entendre le camp des travailleurs,A remplir,3
1014,127,908,537,9,528,371,MN,2014,V,1,31,555,I,537,0,10,Lutte ouvriere faire entendre le camp des travailleurs,A remplir,3
1015,156,889,425,11,414,464,MN,2014,V,1,31,555,I,425,0,10,Lutte ouvriere faire entendre le camp des travailleurs,A remplir,1
1016,159,1232,667,12,655,565,MN,2014,V,1,31,555,I,667,0,10,Lutte ouvriere faire entendre le camp des travailleurs,A remplir,7
1017,169,953,362,11,351,591,MN,2014,V,1,31,555,I,362,0,10,Lutte ouvriere faire entendre le camp des travailleurs,A remplir,5
1018,173,962,388,8,380,574,MN,2014,V,1,31,555,I,388,0,10,Lutte ouvriere faire entendre le camp des travailleurs,A remplir,5
1019,203,848,421,16,405,427,MN,2014,V,1,31,555,I,421,0,10,Lutte ouvriere faire entendre le camp des travailleurs,A remplir,1
1020,203B,1049,585,16,569,464,MN,2014,V,1,31,555,I,585,0,10,Lutte ouvriere faire entendre le camp des travailleurs,A remplir,7
1021,18,1208,703,23,680,505,MN,2014,V,1,31,555,I,703,0,10,Lutte ouvriere faire entendre le camp des travailleurs,A remplir,1
1022,48,1004,509,11,498,495,MN,2014,V,1,31,555,I,509,0,10,Lutte ouvriere faire entendre le camp des travailleurs,A remplir,9
1023,57,882,517,18,499,365,MN,2014,V,1,31,555,I,517,0,10,Lutte ouvriere faire entendre le camp des travailleurs,A remplir,2
1024,68,1002,582,23,559,420,MN,2014,V,1,31,555,I,582,0,10,Lutte ouvriere faire entendre le camp des travailleurs,A remplir,1
1025,128,1114,576,22,554,538,MN,2014,V,1,31,555,I,576,0,10,Lutte ouvriere faire entendre le camp des travailleurs,A remplir,3
1026,137,995,617,10,607,378,MN,2014,V,1,31,555,I,617,0,10,Lutte ouvriere faire entendre le camp des travailleurs,A remplir,1
1027,144A,992,563,13,551,429,MN,2014,V,1,31,555,I,563,0,10,Lutte ouvriere faire entendre le camp des travailleurs,A remplir,2
1028,157,1208,645,11,634,563,MN,2014,V,1,31,555,I,645,0,10,Lutte ouvriere faire entendre le camp des travailleurs,A remplir,1
1029,166,1147,666,12,653,481,MN,2014,V,1,31,555,I,666,0,10,Lutte ouvriere faire entendre le camp des travailleurs,A remplir,1
1030,195,811,443,7,436,368,MN,2014,V,1,31,555,I,443,0,10,Lutte ouvriere faire entendre le camp des travailleurs,A remplir,4
1031,200A,1064,537,13,524,527,MN,2014,V,1,31,555,I,537,0,10,Lutte ouvriere faire entendre le camp des travailleurs,A remplir,1
1032,203A,817,451,6,445,366,MN,2014,V,1,31,555,I,451,0,10,Lutte ouvriere faire entendre le camp des travailleurs,A remplir,2
1033,35,1057,526,10,516,531,MN,2014,V,1,31,555,I,526,0,10,Lutte ouvriere faire entendre le camp des travailleurs,A remplir,3
1034,45,1038,429,8,421,609,MN,2014,V,1,31,555,I,429,0,10,Lutte ouvriere faire entendre le camp des travailleurs,A remplir,3
1035,61,859,467,16,451,392,MN,2014,V,1,31,555,I,467,0,10,Lutte ouvriere faire entendre le camp des travailleurs,A remplir,5
1036,94,1110,641,11,630,469,MN,2014,V,1,31,555,I,641,0,10,Lutte ouvriere faire entendre le camp des travailleurs,A remplir,0
1037,107,1019,581,8,573,438,MN,2014,V,1,31,555,I,581,0,10,Lutte ouvriere faire entendre le camp des travailleurs,A remplir,4
1038,110,918,502,13,489,416,MN,2014,V,1,31,555,I,502,0,10,Lutte ouvriere faire entendre le camp des travailleurs,A remplir,5
1039,134A,1406,745,22,723,661,MN,2014,V,1,31,555,I,745,0,10,Lutte ouvriere faire entendre le camp des travailleurs,A remplir,5
1040,146,833,440,3,437,393,MN,2014,V,1,31,555,I,440,0,10,Lutte ouvriere faire entendre le camp des travailleurs,A remplir,2
1041,186,1299,322,18,304,977,MN,2014,V,1,31,555,I,322,0,10,Lutte ouvriere faire entendre le camp des travailleurs,A remplir,4
1042,195A,1090,474,13,461,616,MN,2014,V,1,31,555,I,474,0,10,Lutte ouvriere faire entendre le camp des travailleurs,A remplir,5
1043,16,947,558,10,548,389,MN,2014,V,1,31,555,I,558,0,10,Lutte ouvriere faire entendre le camp des travailleurs,A remplir,2
1044,39A,938,525,28,497,413,MN,2014,V,1,31,555,I,525,0,10,Lutte ouvriere faire entendre le camp des travailleurs,A remplir,7
1045,85,994,452,13,439,542,MN,2014,V,1,31,555,I,452,0,10,Lutte ouvriere faire entendre le camp des travailleurs,A remplir,2
1046,87,1204,619,8,612,585,MN,2014,V,1,31,555,I,619,0,10,Lutte ouvriere faire entendre le camp des travailleurs,A remplir,3
1047,93B,1235,656,16,640,579,MN,2014,V,1,31,555,I,656,0,10,Lutte ouvriere faire entendre le camp des travailleurs,A remplir,4
1048,101,1126,627,10,617,499,MN,2014,V,1,31,555,I,627,0,10,Lutte ouvriere faire entendre le camp des travailleurs,A remplir,8
1049,104,1042,609,21,588,433,MN,2014,V,1,31,555,I,609,0,10,Lutte ouvriere faire entendre le camp des travailleurs,A remplir,2
1050,112,841,429,10,419,412,MN,2014,V,1,31,555,I,429,0,10,Lutte ouvriere faire entendre le camp des travailleurs,A remplir,1
1051,148,830,418,14,404,412,MN,2014,V,1,31,555,I,418,0,10,Lutte ouvriere faire entendre le camp des travailleurs,A remplir,10
1052,207,1141,602,18,584,539,MN,2014,V,1,31,555,I,602,0,10,Lutte ouvriere faire entendre le camp des travailleurs,A remplir,5
1053,210,1252,597,16,581,655,MN,2014,V,1,31,555,I,597,0,10,Lutte ouvriere faire entendre le camp des travailleurs,A remplir,2
1054,10,979,521,13,508,458,MN,2014,V,1,31,555,I,521,0,10,Lutte ouvriere faire entendre le camp des travailleurs,A remplir,2
1055,77,976,544,9,535,432,MN,2014,V,1,31,555,I,544,0,10,Lutte ouvriere faire entendre le camp des travailleurs,A remplir,0
1056,91,1000,523,15,508,477,MN,2014,V,1,31,555,I,523,0,10,Lutte ouvriere faire entendre le camp des travailleurs,A remplir,3
1057,132,1073,553,5,548,520,MN,2014,V,1,31,555,I,553,0,10,Lutte ouvriere faire entendre le camp des travailleurs,A remplir,1
1058,189,832,311,8,303,521,MN,2014,V,1,31,555,I,311,0,10,Lutte ouvriere faire entendre le camp des travailleurs,A remplir,6
1059,193A,795,360,9,351,435,MN,2014,V,1,31,555,I,360,0,10,Lutte ouvriere faire entendre le camp des travailleurs,A remplir,3
1060,209,1102,507,22,485,595,MN,2014,V,1,31,555,I,507,0,10,Lutte ouvriere faire entendre le camp des travailleurs,A remplir,3
1061,212,442,187,4,183,255,MN,2014,V,1,31,555,I,187,0,10,Lutte ouvriere faire entendre le camp des travailleurs,A remplir,2
1062,4,956,571,10,561,385,MN,2014,V,1,31,555,I,571,0,10,Lutte ouvriere faire entendre le camp des travailleurs,A remplir,2
1063,19,1084,637,8,631,447,MN,2014,V,1,31,555,I,637,0,10,Lutte ouvriere faire entendre le camp des travailleurs,A remplir,3
1064,30,992,554,7,547,438,MN,2014,V,1,31,555,I,554,0,10,Lutte ouvriere faire entendre le camp des travailleurs,A remplir,5
1065,56,1025,487,8,479,538,MN,2014,V,1,31,555,I,487,0,10,Lutte ouvriere faire entendre le camp des travailleurs,A remplir,2
1066,84,1173,642,7,635,531,MN,2014,V,1,31,555,I,642,0,10,Lutte ouvriere faire entendre le camp des travailleurs,A remplir,1
1067,93A,1276,661,14,647,615,MN,2014,V,1,31,555,I,661,0,10,Lutte ouvriere faire entendre le camp des travailleurs,A remplir,5
1068,144,991,611,13,598,380,MN,2014,V,1,31,555,I,611,0,10,Lutte ouvriere faire entendre le camp des travailleurs,A remplir,7
1069,22,1086,605,16,589,481,MN,2014,V,1,31,555,I,605,0,10,Lutte ouvriere faire entendre le camp des travailleurs,A remplir,1
1070,25,1083,547,7,540,536,MN,2014,V,1,31,555,I,547,0,10,Lutte ouvriere faire entendre le camp des travailleurs,A remplir,1
1071,73,1069,531,13,518,538,MN,2014,V,1,31,555,I,531,0,10,Lutte ouvriere faire entendre le camp des travailleurs,A remplir,1
1072,99,933,486,11,475,447,MN,2014,V,1,31,555,I,486,0,10,Lutte ouvriere faire entendre le camp des travailleurs,A remplir,8
1073,103,871,459,18,441,412,MN,2014,V,1,31,555,I,459,0,10,Lutte ouvriere faire entendre le camp des travailleurs,A remplir,5
1074,140,935,559,9,550,376,MN,2014,V,1,31,555,I,559,0,10,Lutte ouvriere faire entendre le camp des travailleurs,A remplir,3
1075,150,1022,574,6,568,448,MN,2014,V,1,31,555,I,574,0,10,Lutte ouvriere faire entendre le camp des travailleurs,A remplir,8
1076,168,934,464,17,447,470,MN,2014,V,1,31,555,I,464,0,10,Lutte ouvriere faire entendre le camp des travailleurs,A remplir,3
1077,22A,1047,587,16,571,460,MN,2014,V,1,31,555,I,587,0,10,Lutte ouvriere faire entendre le camp des travailleurs,A remplir,6
1078,52,1066,539,12,527,527,MN,2014,V,1,31,555,I,539,0,10,Lutte ouvriere faire entendre le camp des travailleurs,A remplir,3
1079,66,862,474,16,458,388,MN,2014,V,1,31,555,I,474,0,10,Lutte ouvriere faire entendre le camp des travailleurs,A remplir,1
1080,96,978,542,17,525,436,MN,2014,V,1,31,555,I,542,0,10,Lutte ouvriere faire entendre le camp des travailleurs,A remplir,3
1081,118,1142,631,12,619,511,MN,2014,V,1,31,555,I,631,0,10,Lutte ouvriere faire entendre le camp des travailleurs,A remplir,1
1082,139,965,529,11,518,436,MN,2014,V,1,31,555,I,529,0,10,Lutte ouvriere faire entendre le camp des travailleurs,A remplir,4
1083,141,957,569,8,561,388,MN,2014,V,1,31,555,I,569,0,10,Lutte ouvriere faire entendre le camp des travailleurs,A remplir,8
1084,164,1183,491,16,475,692,MN,2014,V,1,31,555,I,491,0,10,Lutte ouvriere faire entendre le camp des travailleurs,A remplir,3
1085,181,931,370,12,358,561,MN,2014,V,1,31,555,I,370,0,10,Lutte ouvriere faire entendre le camp des travailleurs,A remplir,4
1086,211A,1286,623,28,595,663,MN,2014,V,1,31,555,I,623,0,10,Lutte ouvriere faire entendre le camp des travailleurs,A remplir,7
1087,2,931,505,12,493,426,MN,2014,V,1,31,555,I,505,0,10,Lutte ouvriere faire entendre le camp des travailleurs,A remplir,1
1088,9,941,528,3,525,413,MN,2014,V,1,31,555,I,528,0,10,Lutte ouvriere faire entendre le camp des travailleurs,A remplir,2
1089,40,1276,595,11,584,681,MN,2014,V,1,31,555,I,595,0,10,Lutte ouvriere faire entendre le camp des travailleurs,A remplir,0
1090,59,1038,581,10,571,457,MN,2014,V,1,31,555,I,581,0,10,Lutte ouvriere faire entendre le camp des travailleurs,A remplir,4
1091,88,1122,596,12,584,526,MN,2014,V,1,31,555,I,596,0,10,Lutte ouvriere faire entendre le camp des travailleurs,A remplir,5
1092,106,962,481,17,465,481,MN,2014,V,1,31,555,I,481,0,10,Lutte ouvriere faire entendre le camp des travailleurs,A remplir,3
1093,120,1058,610,18,592,448,MN,2014,V,1,31,555,I,610,0,10,Lutte ouvriere faire entendre le camp des travailleurs,A remplir,6
1094,145,1015,549,14,535,466,MN,2014,V,1,31,555,I,549,0,10,Lutte ouvriere faire entendre le camp des travailleurs,A remplir,3
1095,149,1123,622,12,610,501,MN,2014,V,1,31,555,I,622,0,10,Lutte ouvriere faire entendre le camp des travailleurs,A remplir,5
1096,201B,1032,580,19,561,452,MN,2014,V,1,31,555,I,580,0,10,Lutte ouvriere faire entendre le camp des travailleurs,A remplir,3
1097,206,1087,549,20,529,538,MN,2014,V,1,31,555,I,549,0,10,Lutte ouvriere faire entendre le camp des travailleurs,A remplir,4
1098,55,1082,614,14,600,468,MN,2014,V,1,31,555,I,614,0,10,Lutte ouvriere faire entendre le camp des travailleurs,A remplir,2
1099,83,1176,712,10,702,464,MN,2014,V,1,31,555,I,712,0,10,Lutte ouvriere faire entendre le camp des travailleurs,A remplir,2
1100,136,730,449,8,442,281,MN,2014,V,1,31,555,I,449,0,10,Lutte ouvriere faire entendre le camp des travailleurs,A remplir,2
1101,158,1155,634,10,624,521,MN,2014,V,1,31,555,I,634,0,10,Lutte ouvriere faire entendre le camp des travailleurs,A remplir,5
1102,162,1033,534,12,522,499,MN,2014,V,1,31,555,I,534,0,10,Lutte ouvriere faire entendre le camp des travailleurs,A remplir,3
1103,170,819,446,8,438,373,MN,2014,V,1,31,555,I,446,0,10,Lutte ouvriere faire entendre le camp des travailleurs,A remplir,4
1104,172,870,533,11,522,337,MN,2014,V,1,31,555,I,533,0,10,Lutte ouvriere faire entendre le camp des travailleurs,A remplir,2
1105,222,1321,665,21,644,656,MN,2014,V,1,31,555,I,665,0,10,Lutte ouvriere faire entendre le camp des travailleurs,A remplir,6
1106,7,928,450,9,441,478,MN,2014,V,1,31,555,I,450,0,10,Lutte ouvriere faire entendre le camp des travailleurs,A remplir,2
1107,11,1115,633,14,620,482,MN,2014,V,1,31,555,I,633,0,10,Lutte ouvriere faire entendre le camp des travailleurs,A remplir,2
1108,21,944,561,12,549,383,MN,2014,V,1,31,555,I,561,0,10,Lutte ouvriere faire entendre le camp des travailleurs,A remplir,1
1109,53,1067,569,13,556,498,MN,2014,V,1,31,555,I,569,0,10,Lutte ouvriere faire entendre le camp des travailleurs,A remplir,7
1110,122,1038,637,5,632,401,MN,2014,V,1,31,555,I,637,0,10,Lutte ouvriere faire entendre le camp des travailleurs,A remplir,0
1111,124,1082,650,16,634,432,MN,2014,V,1,31,555,I,650,0,10,Lutte ouvriere faire entendre le camp des travailleurs,A remplir,1
1112,129,990,483,16,467,507,MN,2014,V,1,31,555,I,483,0,10,Lutte ouvriere faire entendre le camp des travailleurs,A remplir,3
1113,134,875,516,10,506,359,MN,2014,V,1,31,555,I,516,0,10,Lutte ouvriere faire entendre le camp des travailleurs,A remplir,2
1114,135,1027,636,7,630,391,MN,2014,V,1,31,555,I,636,0,10,Lutte ouvriere faire entendre le camp des travailleurs,A remplir,0
1115,175,995,320,11,309,675,MN,2014,V,1,31,555,I,320,0,10,Lutte ouvriere faire entendre le camp des travailleurs,A remplir,1
1116,177,1084,439,24,415,645,MN,2014,V,1,31,555,I,439,0,10,Lutte ouvriere faire entendre le camp des travailleurs,A remplir,1
1117,193,650,268,4,264,382,MN,2014,V,1,31,555,I,268,0,10,Lutte ouvriere faire entendre le camp des travailleurs,A remplir,4
1118,199,503,252,4,248,251,MN,2014,V,1,31,555,I,252,0,10,Lutte ouvriere faire entendre le camp des travailleurs,A remplir,0
1119,213,1101,583,17,566,518,MN,2014,V,1,31,555,I,583,0,10,Lutte ouvriere faire entendre le camp des travailleurs,A remplir,4
1120,219,1138,614,10,604,524,MN,2014,V,1,31,555,I,614,0,10,Lutte ouvriere faire entendre le camp des travailleurs,A remplir,5
1121,12,1116,608,12,596,508,MN,2014,V,1,31,555,I,608,0,10,Lutte ouvriere faire entendre le camp des travailleurs,A remplir,2
1122,31,1020,561,8,553,459,MN,2014,V,1,31,555,I,561,0,10,Lutte ouvriere faire entendre le camp des travailleurs,A remplir,0
1123,36,806,435,14,421,371,MN,2014,V,1,31,555,I,435,0,10,Lutte ouvriere faire entendre le camp des travailleurs,A remplir,4
1124,46,986,558,11,547,428,MN,2014,V,1,31,555,I,558,0,10,Lutte ouvriere faire entendre le camp des travailleurs,A remplir,1
1125,81,1177,499,16,483,678,MN,2014,V,1,31,555,I,499,0,10,Lutte ouvriere faire entendre le camp des travailleurs,A remplir,4
1126,142,890,459,6,453,431,MN,2014,V,1,31,555,I,459,0,10,Lutte ouvriere faire entendre le camp des travailleurs,A remplir,1
1127,152,944,355,14,341,589,MN,2014,V,1,31,555,I,355,0,10,Lutte ouvriere faire entendre le camp des travailleurs,A remplir,3
1128,167,995,543,9,534,452,MN,2014,V,1,31,555,I,543,0,10,Lutte ouvriere faire entendre le camp des travailleurs,A remplir,4
1129,190,1008,247,9,238,761,MN,2014,V,1,31,555,I,247,0,10,Lutte ouvriere faire entendre le camp des travailleurs,A remplir,3
1130,225,838,451,16,435,387,MN,2014,V,1,31,555,I,451,0,10,Lutte ouvriere faire entendre le camp des travailleurs,A remplir,8
1131,49,759,440,8,432,319,MN,2014,V,1,31,555,I,440,0,10,Lutte ouvriere faire entendre le camp des travailleurs,A remplir,1
1132,50,977,533,16,517,444,MN,2014,V,1,31,555,I,533,0,10,Lutte ouvriere faire entendre le camp des travailleurs,A remplir,3
1133,60,1164,611,25,586,553,MN,2014,V,1,31,555,I,611,0,10,Lutte ouvriere faire entendre le camp des travailleurs,A remplir,4
1134,108A,939,523,13,510,416,MN,2014,V,1,31,555,I,523,0,10,Lutte ouvriere faire entendre le camp des travailleurs,A remplir,1
1135,125,957,575,11,564,382,MN,2014,V,1,31,555,I,575,0,10,Lutte ouvriere faire entendre le camp des travailleurs,A remplir,1
1136,182,794,435,10,425,359,MN,2014,V,1,31,555,I,435,0,10,Lutte ouvriere faire entendre le camp des travailleurs,A remplir,5
1137,215,1373,629,18,611,744,MN,2014,V,1,31,555,I,629,0,10,Lutte ouvriere faire entendre le camp des travailleurs,A remplir,4
1138,1,1100,541,10,532,559,MN,2014,V,1,31,555,I,541,0,10,Lutte ouvriere faire entendre le camp des travailleurs,A remplir,3
1139,44,971,558,16,542,413,MN,2014,V,1,31,555,I,558,0,10,Lutte ouvriere faire entendre le camp des travailleurs,A remplir,6
1140,49A,856,513,8,505,343,MN,2014,V,1,31,555,I,513,0,10,Lutte ouvriere faire entendre le camp des travailleurs,A remplir,0
1141,165A,982,609,11,598,373,MN,2014,V,1,31,555,I,609,0,10,Lutte ouvriere faire entendre le camp des travailleurs,A remplir,2
1142,200,1192,654,15,639,538,MN,2014,V,1,31,555,I,654,0,10,Lutte ouvriere faire entendre le camp des travailleurs,A remplir,1
1143,5,772,439,10,429,333,MN,2014,V,1,31,555,I,439,0,10,Lutte ouvriere faire entendre le camp des travailleurs,A remplir,2
1144,24,1061,543,8,535,518,MN,2014,V,1,31,555,I,543,0,10,Lutte ouvriere faire entendre le camp des travailleurs,A remplir,1
1145,25A,1002,518,11,507,484,MN,2014,V,1,31,555,I,518,0,10,Lutte ouvriere faire entendre le camp des travailleurs,A remplir,3
1146,51,1230,659,18,641,571,MN,2014,V,1,31,555,I,659,0,10,Lutte ouvriere faire entendre le camp des travailleurs,A remplir,8
1147,71,941,513,10,504,428,MN,2014,V,1,31,555,I,513,0,10,Lutte ouvriere faire entendre le camp des travailleurs,A remplir,6
1148,78,1006,624,19,605,382,MN,2014,V,1,31,555,I,624,0,10,Lutte ouvriere faire entendre le camp des travailleurs,A remplir,5
1149,79,915,498,6,491,417,MN,2014,V,1,31,555,I,498,0,10,Lutte ouvriere faire entendre le camp des travailleurs,A remplir,4
1150,80,1173,553,9,544,620,MN,2014,V,1,31,555,I,553,0,10,Lutte ouvriere faire entendre le camp des travailleurs,A remplir,0
1151,97,1084,564,10,553,520,MN,2014,V,1,31,555,I,564,0,10,Lutte ouvriere faire entendre le camp des travailleurs,A remplir,2
1152,184,1151,355,10,345,796,MN,2014,V,1,31,555,I,355,0,10,Lutte ouvriere faire entendre le camp des travailleurs,A remplir,5
1153,188,1220,497,20,477,723,MN,2014,V,1,31,555,I,497,0,10,Lutte ouvriere faire entendre le camp des travailleurs,A remplir,5
1154,8,891,480,13,467,411,MN,2014,V,1,31,555,I,480,0,10,Lutte ouvriere faire entendre le camp des travailleurs,A remplir,0
1155,14,1014,595,6,589,419,MN,2014,V,1,31,555,I,595,0,10,Lutte ouvriere faire entendre le camp des travailleurs,A remplir,0
1156,34,953,496,10,486,457,MN,2014,V,1,31,555,I,496,0,10,Lutte ouvriere faire entendre le camp des travailleurs,A remplir,2
1157,39,1160,603,12,591,557,MN,2014,V,1,31,555,I,603,0,10,Lutte ouvriere faire entendre le camp des travailleurs,A remplir,3
1158,63,806,314,6,308,492,MN,2014,V,1,31,555,I,314,0,10,Lutte ouvriere faire entendre le camp des travailleurs,A remplir,1
1159,124A,982,582,15,567,400,MN,2014,V,1,31,555,I,582,0,10,Lutte ouvriere faire entendre le camp des travailleurs,A remplir,7
1160,205,1184,651,18,633,533,MN,2014,V,1,31,555,I,651,0,10,Lutte ouvriere faire entendre le camp des travailleurs,A remplir,3
1161,6,1098,531,11,520,567,MN,2014,V,1,31,555,I,531,0,10,Lutte ouvriere faire entendre le camp des travailleurs,A remplir,3
1162,23,1205,614,7,607,591,MN,2014,V,1,31,555,I,614,0,10,Lutte ouvriere faire entendre le camp des travailleurs,A remplir,3
1163,64,1233,675,22,653,558,MN,2014,V,1,31,555,I,675,0,10,Lutte ouvriere faire entendre le camp des travailleurs,A remplir,3
1164,75,949,456,15,441,493,MN,2014,V,1,31,555,I,456,0,10,Lutte ouvriere faire entendre le camp des travailleurs,A remplir,5
1165,76,1007,517,7,510,490,MN,2014,V,1,31,555,I,517,0,10,Lutte ouvriere faire entendre le camp des travailleurs,A remplir,8
1166,111,956,511,10,501,445,MN,2014,V,1,31,555,I,511,0,10,Lutte ouvriere faire entendre le camp des travailleurs,A remplir,6
1167,123,1134,589,8,581,545,MN,2014,V,1,31,555,I,589,0,10,Lutte ouvriere faire entendre le camp des travailleurs,A remplir,3
1168,131,1051,602,12,590,449,MN,2014,V,1,31,555,I,602,0,10,Lutte ouvriere faire entendre le camp des travailleurs,A remplir,4
1169,154,809,278,13,265,531,MN,2014,V,1,31,555,I,278,0,10,Lutte ouvriere faire entendre le camp des travailleurs,A remplir,1
1170,179,709,357,9,348,352,MN,2014,V,1,31,555,I,357,0,10,Lutte ouvriere faire entendre le camp des travailleurs,A remplir,5
1171,211,1377,732,18,714,645,MN,2014,V,1,31,555,I,732,0,10,Lutte ouvriere faire entendre le camp des travailleurs,A remplir,0
1172,13,1041,588,11,577,453,MN,2014,V,1,31,555,I,588,0,10,Lutte ouvriere faire entendre le camp des travailleurs,A remplir,2
1173,15,1078,643,10,633,435,MN,2014,V,1,31,555,I,643,0,10,Lutte ouvriere faire entendre le camp des travailleurs,A remplir,2
1174,27,1122,647,10,637,475,MN,2014,V,1,31,555,I,647,0,10,Lutte ouvriere faire entendre le camp des travailleurs,A remplir,8
1175,36A,1124,605,14,591,519,MN,2014,V,1,31,555,I,605,0,10,Lutte ouvriere faire entendre le camp des travailleurs,A remplir,5
1176,56A,894,469,9,460,425,MN,2014,V,1,31,555,I,469,0,10,Lutte ouvriere faire entendre le camp des travailleurs,A remplir,2
1177,69,1090,574,12,562,516,MN,2014,V,1,31,555,I,574,0,10,Lutte ouvriere faire entendre le camp des travailleurs,A remplir,3
1178,113,1030,455,18,437,575,MN,2014,V,1,31,555,I,455,0,10,Lutte ouvriere faire entendre le camp des travailleurs,A remplir,3
1179,147,1006,591,11,580,415,MN,2014,V,1,31,555,I,591,0,10,Lutte ouvriere faire entendre le camp des travailleurs,A remplir,2
1180,165,1463,797,24,773,666,MN,2014,V,1,31,555,I,797,0,10,Lutte ouvriere faire entendre le camp des travailleurs,A remplir,2
1181,201A,1154,711,21,690,443,MN,2014,V,1,31,555,I,711,0,10,Lutte ouvriere faire entendre le camp des travailleurs,A remplir,1
1182,204,1153,587,18,569,566,MN,2014,V,1,31,555,I,587,0,10,Lutte ouvriere faire entendre le camp des travailleurs,A remplir,1
1183,218,1264,701,15,686,563,MN,2014,V,1,31,555,I,701,0,10,Lutte ouvriere faire entendre le camp des travailleurs,A remplir,6
1184,220,1242,685,19,666,557,MN,2014,V,1,31,555,I,685,0,10,Lutte ouvriere faire entendre le camp des travailleurs,A remplir,6
1185,42,962,516,14,502,446,MN,2014,V,1,31,555,I,516,0,10,Lutte ouvriere faire entendre le camp des travailleurs,A remplir,0
1186,58,1199,536,13,523,663,MN,2014,V,1,31,555,I,536,0,10,Lutte ouvriere faire entendre le camp des travailleurs,A remplir,3
1187,95,1039,530,11,519,509,MN,2014,V,1,31,555,I,530,0,10,Lutte ouvriere faire entendre le camp des travailleurs,A remplir,4
1188,116,1060,541,13,528,519,MN,2014,V,1,31,555,I,541,0,10,Lutte ouvriere faire entendre le camp des travailleurs,A remplir,7
1189,151,983,544,9,535,439,MN,2014,V,1,31,555,I,544,0,10,Lutte ouvriere faire entendre le camp des travailleurs,A remplir,5
1190,155,726,257,7,250,469,MN,2014,V,1,31,555,I,257,0,10,Lutte ouvriere faire entendre le camp des travailleurs,A remplir,0
1191,198B,1072,625,17,608,447,MN,2014,V,1,31,555,I,625,0,10,Lutte ouvriere faire entendre le camp des travailleurs,A remplir,1
1192,201,1015,630,10,620,385,MN,2014,V,1,31,555,I,630,0,10,Lutte ouvriere faire entendre le camp des travailleurs,A remplir,3
1193,224,780,412,11,401,368,MN,2014,V,1,31,555,I,412,0,10,Lutte ouvriere faire entendre le camp des travailleurs,A remplir,5
1194,17,940,535,10,525,405,MN,2014,V,1,31,555,I,535,0,10,Lutte ouvriere faire entendre le camp des travailleurs,A remplir,8
1195,65,1142,646,19,627,496,MN,2014,V,1,31,555,I,646,0,10,Lutte ouvriere faire entendre le camp des travailleurs,A remplir,4
1196,67,983,550,21,529,433,MN,2014,V,1,31,555,I,550,0,10,Lutte ouvriere faire entendre le camp des travailleurs,A remplir,1
1197,102,739,369,8,361,370,MN,2014,V,1,31,555,I,369,0,10,Lutte ouvriere faire entendre le camp des travailleurs,A remplir,3
1198,113A,976,526,13,513,450,MN,2014,V,1,31,555,I,526,0,10,Lutte ouvriere faire entendre le camp des travailleurs,A remplir,6
1199,119,970,576,9,567,394,MN,2014,V,1,31,555,I,576,0,10,Lutte ouvriere faire entendre le camp des travailleurs,A remplir,1
1200,191A,925,327,20,307,598,MN,2014,V,1,31,555,I,327,0,10,Lutte ouvriere faire entendre le camp des travailleurs,A remplir,5
1201,198,1241,700,19,681,541,MN,2014,V,1,31,555,I,700,0,10,Lutte ouvriere faire entendre le camp des travailleurs,A remplir,1
1202,208,1196,696,27,669,500,MN,2014,V,1,31,555,I,696,0,10,Lutte ouvriere faire entendre le camp des travailleurs,A remplir,7
1203,32,848,516,8,508,332,MN,2014,V,1,31,555,I,516,0,10,Lutte ouvriere faire entendre le camp des travailleurs,A remplir,1
1204,33,1059,631,17,614,428,MN,2014,V,1,31,555,I,631,0,10,Lutte ouvriere faire entendre le camp des travailleurs,A remplir,3
1205,44B,805,394,16,378,411,MN,2014,V,1,31,555,I,394,0,10,Lutte ouvriere faire entendre le camp des travailleurs,A remplir,1
1206,54,991,513,15,497,478,MN,2014,V,1,31,555,I,513,0,10,Lutte ouvriere faire entendre le camp des travailleurs,A remplir,9
1207,92,1184,581,19,562,603,MN,2014,V,1,31,555,I,581,0,10,Lutte ouvriere faire entendre le camp des travailleurs,A remplir,3
1208,93,1248,671,22,649,577,MN,2014,V,1,31,555,I,671,0,10,Lutte ouvriere faire entendre le camp des travailleurs,A remplir,4
1209,108,1029,598,16,582,431,MN,2014,V,1,31,555,I,598,0,10,Lutte ouvriere faire entendre le camp des travailleurs,A remplir,2
1210,138,889,558,15,543,331,MN,2014,V,1,31,555,I,558,0,10,Lutte ouvriere faire entendre le camp des travailleurs,A remplir,0
1211,153,706,148,5,143,558,MN,2014,V,1,31,555,I,148,0,10,Lutte ouvriere faire entendre le camp des travailleurs,A remplir,2
1212,163,1016,466,7,460,550,MN,2014,V,1,31,555,I,466,0,10,Lutte ouvriere faire entendre le camp des travailleurs,A remplir,5
1213,191,1000,255,12,243,745,MN,2014,V,1,31,555,I,255,0,10,Lutte ouvriere faire entendre le camp des travailleurs,A remplir,1
1214,197,994,590,20,570,404,MN,2014,V,1,31,555,I,590,0,10,Lutte ouvriere faire entendre le camp des travailleurs,A remplir,5
1215,198A,955,556,15,541,399,MN,2014,V,1,31,555,I,556,0,10,Lutte ouvriere faire entendre le camp des travailleurs,A remplir,2
1216,223,1190,637,21,616,553,MN,2014,V,1,31,555,I,637,0,10,Lutte ouvriere faire entendre le camp des travailleurs,A remplir,2
1217,226,987,505,6,499,482,MN,2014,V,1,31,555,I,505,0,10,Lutte ouvriere faire entendre le camp des travailleurs,A remplir,5
1218,37,890,465,15,450,425,MN,2014,V,1,31,555,I,465,0,10,Lutte ouvriere faire entendre le camp des travailleurs,A remplir,7
1219,70,1004,580,14,566,424,MN,2014,V,1,31,555,I,580,0,10,Lutte ouvriere faire entendre le camp des travailleurs,A remplir,3
1220,74,1059,538,7,531,521,MN,2014,V,1,31,555,I,538,0,10,Lutte ouvriere faire entendre le camp des travailleurs,A remplir,1
1221,178,970,371,10,361,599,MN,2014,V,1,31,555,I,371,0,10,Lutte ouvriere faire entendre le camp des travailleurs,A remplir,4
1222,10A,1006,494,11,483,512,MN,2014,V,1,31,555,I,494,0,10,Lutte ouvriere faire entendre le camp des travailleurs,A remplir,2
1223,29,1159,606,9,598,553,MN,2014,V,1,31,555,I,606,0,10,Lutte ouvriere faire entendre le camp des travailleurs,A remplir,2
1224,67A,929,482,11,471,447,MN,2014,V,1,31,555,I,482,0,10,Lutte ouvriere faire entendre le camp des travailleurs,A remplir,7
1225,100,1027,479,9,470,548,MN,2014,V,1,31,555,I,479,0,10,Lutte ouvriere faire entendre le camp des travailleurs,A remplir,0
1226,114,1108,530,15,515,578,MN,2014,V,1,31,555,I,530,0,10,Lutte ouvriere faire entendre le camp des travailleurs,A remplir,5
1227,126,911,511,9,502,400,MN,2014,V,1,31,555,I,511,0,10,Lutte ouvriere faire entendre le camp des travailleurs,A remplir,3
1228,130,1083,574,13,561,509,MN,2014,V,1,31,555,I,574,0,10,Lutte ouvriere faire entendre le camp des travailleurs,A remplir,4
1229,161,967,524,11,513,443,MN,2014,V,1,31,555,I,524,0,10,Lutte ouvriere faire entendre le camp des travailleurs,A remplir,8
1230,174,1101,559,8,551,542,MN,2014,V,1,31,555,I,559,0,10,Lutte ouvriere faire entendre le camp des travailleurs,A remplir,6
1231,202,1197,556,19,537,641,MN,2014,V,1,31,555,I,556,0,10,Lutte ouvriere faire entendre le camp des travailleurs,A remplir,1
1232,216,1186,583,17,566,603,MN,2014,V,1,31,555,I,583,0,10,Lutte ouvriere faire entendre le camp des travailleurs,A remplir,5
1233,216A,1122,459,20,439,663,MN,2014,V,1,31,555,I,459,0,10,Lutte ouvriere faire entendre le camp des travailleurs,A remplir,4
1234,20,1041,656,16,640,385,MN,2014,V,1,31,555,I,656,0,10,Lutte ouvriere faire entendre le camp des travailleurs,A remplir,1
1235,38,975,516,18,498,459,MN,2014,V,1,31,555,I,516,0,10,Lutte ouvriere faire entendre le camp des travailleurs,A remplir,1
1236,43,1026,583,21,562,443,MN,2014,V,1,31,555,I,583,0,10,Lutte ouvriere faire entendre le camp des travailleurs,A remplir,2
1237,133,983,556,15,541,427,MN,2014,V,1,31,555,I,556,0,10,Lutte ouvriere faire entendre le camp des travailleurs,A remplir,3
1238,138A,951,606,17,589,345,MN,2014,V,1,31,555,I,606,0,10,Lutte ouvriere faire entendre le camp des travailleurs,A remplir,2
1239,143,984,592,9,583,392,MN,2014,V,1,31,555,I,592,0,10,Lutte ouvriere faire entendre le camp des travailleurs,A remplir,4
1240,160,1056,563,10,553,493,MN,2014,V,1,31,555,I,563,0,10,Lutte ouvriere faire entendre le camp des travailleurs,A remplir,0
1241,180,755,275,2,273,480,MN,2014,V,1,31,555,I,275,0,10,Lutte ouvriere faire entendre le camp des travailleurs,A remplir,0
1242,195B,1078,677,18,659,401,MN,2014,V,1,31,555,I,677,0,10,Lutte ouvriere faire entendre le camp des travailleurs,A remplir,7
1243,196,1165,666,15,651,499,MN,2014,V,1,31,555,I,666,0,10,Lutte ouvriere faire entendre le camp des travailleurs,A remplir,0
1244,217,1275,630,18,612,645,MN,2014,V,1,31,555,I,630,0,10,Lutte ouvriere faire entendre le camp des travailleurs,A remplir,6
1245,28,1074,561,7,554,513,MN,2014,V,1,31,555,I,561,0,10,"A toulouse, place au peuple - front de gauche",A remplir,26
1246,41,975,548,11,537,427,MN,2014,V,1,31,555,I,548,0,10,"A toulouse, place au peuple - front de gauche",A remplir,32
1247,72,1046,510,5,505,536,MN,2014,V,1,31,555,I,510,0,10,"A toulouse, place au peuple - front de gauche",A remplir,39
1248,105,961,472,16,456,489,MN,2014,V,1,31,555,I,472,0,10,"A toulouse, place au peuple - front de gauche",A remplir,21
1249,109,1098,619,15,604,479,MN,2014,V,1,31,555,I,619,0,10,"A toulouse, place au peuple - front de gauche",A remplir,22
1250,117,1119,551,9,542,568,MN,2014,V,1,31,555,I,551,0,10,"A toulouse, place au peuple - front de gauche",A remplir,33
1251,121,1065,621,6,615,444,MN,2014,V,1,31,555,I,621,0,10,"A toulouse, place au peuple - front de gauche",A remplir,26
1252,171,1072,450,13,437,622,MN,2014,V,1,31,555,I,450,0,10,"A toulouse, place au peuple - front de gauche",A remplir,28
1253,174A,1093,484,9,475,609,MN,2014,V,1,31,555,I,484,0,10,"A toulouse, place au peuple - front de gauche",A remplir,32
1254,192,698,315,9,306,383,MN,2014,V,1,31,555,I,315,0,10,"A toulouse, place au peuple - front de gauche",A remplir,25
1255,194,863,405,15,390,458,MN,2014,V,1,31,555,I,405,0,10,"A toulouse, place au peuple - front de gauche",A remplir,23
1256,214,1312,659,16,643,653,MN,2014,V,1,31,555,I,659,0,10,"A toulouse, place au peuple - front de gauche",A remplir,31
1257,3,919,501,10,491,418,MN,2014,V,1,31,555,I,501,0,10,"A toulouse, place au peuple - front de gauche",A remplir,16
1258,44A,1061,529,19,510,532,MN,2014,V,1,31,555,I,529,0,10,"A toulouse, place au peuple - front de gauche",A remplir,20
1259,47,1034,588,11,577,446,MN,2014,V,1,31,555,I,588,0,10,"A toulouse, place au peuple - front de gauche",A remplir,54
1260,62,1049,498,12,486,551,MN,2014,V,1,31,555,I,498,0,10,"A toulouse, place au peuple - front de gauche",A remplir,28
1261,82,976,490,12,478,486,MN,2014,V,1,31,555,I,490,0,10,"A toulouse, place au peuple - front de gauche",A remplir,20
1262,86,1070,542,8,534,528,MN,2014,V,1,31,555,I,542,0,10,"A toulouse, place au peuple - front de gauche",A remplir,34
1263,127,908,537,9,528,371,MN,2014,V,1,31,555,I,537,0,10,"A toulouse, place au peuple - front de gauche",A remplir,15
1264,156,889,425,11,414,464,MN,2014,V,1,31,555,I,425,0,10,"A toulouse, place au peuple - front de gauche",A remplir,16
1265,159,1232,667,12,655,565,MN,2014,V,1,31,555,I,667,0,10,"A toulouse, place au peuple - front de gauche",A remplir,59
1266,169,953,362,11,351,591,MN,2014,V,1,31,555,I,362,0,10,"A toulouse, place au peuple - front de gauche",A remplir,26
1267,173,962,388,8,380,574,MN,2014,V,1,31,555,I,388,0,10,"A toulouse, place au peuple - front de gauche",A remplir,13
1268,203,848,421,16,405,427,MN,2014,V,1,31,555,I,421,0,10,"A toulouse, place au peuple - front de gauche",A remplir,17
1269,203B,1049,585,16,569,464,MN,2014,V,1,31,555,I,585,0,10,"A toulouse, place au peuple - front de gauche",A remplir,28
1270,18,1208,703,23,680,505,MN,2014,V,1,31,555,I,703,0,10,"A toulouse, place au peuple - front de gauche",A remplir,34
1271,48,1004,509,11,498,495,MN,2014,V,1,31,555,I,509,0,10,"A toulouse, place au peuple - front de gauche",A remplir,39
1272,57,882,517,18,499,365,MN,2014,V,1,31,555,I,517,0,10,"A toulouse, place au peuple - front de gauche",A remplir,23
1273,68,1002,582,23,559,420,MN,2014,V,1,31,555,I,582,0,10,"A toulouse, place au peuple - front de gauche",A remplir,26
1274,128,1114,576,22,554,538,MN,2014,V,1,31,555,I,576,0,10,"A toulouse, place au peuple - front de gauche",A remplir,23
1275,137,995,617,10,607,378,MN,2014,V,1,31,555,I,617,0,10,"A toulouse, place au peuple - front de gauche",A remplir,15
1276,144A,992,563,13,551,429,MN,2014,V,1,31,555,I,563,0,10,"A toulouse, place au peuple - front de gauche",A remplir,38
1277,157,1208,645,11,634,563,MN,2014,V,1,31,555,I,645,0,10,"A toulouse, place au peuple - front de gauche",A remplir,32
1278,166,1147,666,12,653,481,MN,2014,V,1,31,555,I,666,0,10,"A toulouse, place au peuple - front de gauche",A remplir,45
1279,195,811,443,7,436,368,MN,2014,V,1,31,555,I,443,0,10,"A toulouse, place au peuple - front de gauche",A remplir,13
1280,200A,1064,537,13,524,527,MN,2014,V,1,31,555,I,537,0,10,"A toulouse, place au peuple - front de gauche",A remplir,24
1281,203A,817,451,6,445,366,MN,2014,V,1,31,555,I,451,0,10,"A toulouse, place au peuple - front de gauche",A remplir,19
1282,35,1057,526,10,516,531,MN,2014,V,1,31,555,I,526,0,10,"A toulouse, place au peuple - front de gauche",A remplir,44
1283,45,1038,429,8,421,609,MN,2014,V,1,31,555,I,429,0,10,"A toulouse, place au peuple - front de gauche",A remplir,35
1284,61,859,467,16,451,392,MN,2014,V,1,31,555,I,467,0,10,"A toulouse, place au peuple - front de gauche",A remplir,22
1285,94,1110,641,11,630,469,MN,2014,V,1,31,555,I,641,0,10,"A toulouse, place au peuple - front de gauche",A remplir,60
1286,107,1019,581,8,573,438,MN,2014,V,1,31,555,I,581,0,10,"A toulouse, place au peuple - front de gauche",A remplir,24
1287,110,918,502,13,489,416,MN,2014,V,1,31,555,I,502,0,10,"A toulouse, place au peuple - front de gauche",A remplir,22
1288,134A,1406,745,22,723,661,MN,2014,V,1,31,555,I,745,0,10,"A toulouse, place au peuple - front de gauche",A remplir,34
1289,146,833,440,3,437,393,MN,2014,V,1,31,555,I,440,0,10,"A toulouse, place au peuple - front de gauche",A remplir,21
1290,186,1299,322,18,304,977,MN,2014,V,1,31,555,I,322,0,10,"A toulouse, place au peuple - front de gauche",A remplir,16
1291,195A,1090,474,13,461,616,MN,2014,V,1,31,555,I,474,0,10,"A toulouse, place au peuple - front de gauche",A remplir,25
1292,16,947,558,10,548,389,MN,2014,V,1,31,555,I,558,0,10,"A toulouse, place au peuple - front de gauche",A remplir,18
1293,39A,938,525,28,497,413,MN,2014,V,1,31,555,I,525,0,10,"A toulouse, place au peuple - front de gauche",A remplir,35
1294,85,994,452,13,439,542,MN,2014,V,1,31,555,I,452,0,10,"A toulouse, place au peuple - front de gauche",A remplir,26
1295,87,1204,619,8,612,585,MN,2014,V,1,31,555,I,619,0,10,"A toulouse, place au peuple - front de gauche",A remplir,54
1296,93B,1235,656,16,640,579,MN,2014,V,1,31,555,I,656,0,10,"A toulouse, place au peuple - front de gauche",A remplir,31
1297,101,1126,627,10,617,499,MN,2014,V,1,31,555,I,627,0,10,"A toulouse, place au peuple - front de gauche",A remplir,49
1298,104,1042,609,21,588,433,MN,2014,V,1,31,555,I,609,0,10,"A toulouse, place au peuple - front de gauche",A remplir,29
1299,112,841,429,10,419,412,MN,2014,V,1,31,555,I,429,0,10,"A toulouse, place au peuple - front de gauche",A remplir,16
1300,148,830,418,14,404,412,MN,2014,V,1,31,555,I,418,0,10,"A toulouse, place au peuple - front de gauche",A remplir,22
1301,207,1141,602,18,584,539,MN,2014,V,1,31,555,I,602,0,10,"A toulouse, place au peuple - front de gauche",A remplir,27
1302,210,1252,597,16,581,655,MN,2014,V,1,31,555,I,597,0,10,"A toulouse, place au peuple - front de gauche",A remplir,37
1303,10,979,521,13,508,458,MN,2014,V,1,31,555,I,521,0,10,"A toulouse, place au peuple - front de gauche",A remplir,12
1304,77,976,544,9,535,432,MN,2014,V,1,31,555,I,544,0,10,"A toulouse, place au peuple - front de gauche",A remplir,28
1305,91,1000,523,15,508,477,MN,2014,V,1,31,555,I,523,0,10,"A toulouse, place au peuple - front de gauche",A remplir,26
1306,132,1073,553,5,548,520,MN,2014,V,1,31,555,I,553,0,10,"A toulouse, place au peuple - front de gauche",A remplir,22
1307,189,832,311,8,303,521,MN,2014,V,1,31,555,I,311,0,10,"A toulouse, place au peuple - front de gauche",A remplir,18
1308,193A,795,360,9,351,435,MN,2014,V,1,31,555,I,360,0,10,"A toulouse, place au peuple - front de gauche",A remplir,16
1309,209,1102,507,22,485,595,MN,2014,V,1,31,555,I,507,0,10,"A toulouse, place au peuple - front de gauche",A remplir,18
1310,212,442,187,4,183,255,MN,2014,V,1,31,555,I,187,0,10,"A toulouse, place au peuple - front de gauche",A remplir,7
1311,4,956,571,10,561,385,MN,2014,V,1,31,555,I,571,0,10,"A toulouse, place au peuple - front de gauche",A remplir,12
1312,19,1084,637,8,631,447,MN,2014,V,1,31,555,I,637,0,10,"A toulouse, place au peuple - front de gauche",A remplir,25
1313,30,992,554,7,547,438,MN,2014,V,1,31,555,I,554,0,10,"A toulouse, place au peuple - front de gauche",A remplir,21
1314,56,1025,487,8,479,538,MN,2014,V,1,31,555,I,487,0,10,"A toulouse, place au peuple - front de gauche",A remplir,20
1315,84,1173,642,7,635,531,MN,2014,V,1,31,555,I,642,0,10,"A toulouse, place au peuple - front de gauche",A remplir,28
1316,93A,1276,661,14,647,615,MN,2014,V,1,31,555,I,661,0,10,"A toulouse, place au peuple - front de gauche",A remplir,33
1317,144,991,611,13,598,380,MN,2014,V,1,31,555,I,611,0,10,"A toulouse, place au peuple - front de gauche",A remplir,21
1318,22,1086,605,16,589,481,MN,2014,V,1,31,555,I,605,0,10,"A toulouse, place au peuple - front de gauche",A remplir,16
1319,25,1083,547,7,540,536,MN,2014,V,1,31,555,I,547,0,10,"A toulouse, place au peuple - front de gauche",A remplir,39
1320,73,1069,531,13,518,538,MN,2014,V,1,31,555,I,531,0,10,"A toulouse, place au peuple - front de gauche",A remplir,23
1321,99,933,486,11,475,447,MN,2014,V,1,31,555,I,486,0,10,"A toulouse, place au peuple - front de gauche",A remplir,29
1322,103,871,459,18,441,412,MN,2014,V,1,31,555,I,459,0,10,"A toulouse, place au peuple - front de gauche",A remplir,30
1323,140,935,559,9,550,376,MN,2014,V,1,31,555,I,559,0,10,"A toulouse, place au peuple - front de gauche",A remplir,25
1324,150,1022,574,6,568,448,MN,2014,V,1,31,555,I,574,0,10,"A toulouse, place au peuple - front de gauche",A remplir,29
1325,168,934,464,17,447,470,MN,2014,V,1,31,555,I,464,0,10,"A toulouse, place au peuple - front de gauche",A remplir,35
1326,22A,1047,587,16,571,460,MN,2014,V,1,31,555,I,587,0,10,"A toulouse, place au peuple - front de gauche",A remplir,33
1327,52,1066,539,12,527,527,MN,2014,V,1,31,555,I,539,0,10,"A toulouse, place au peuple - front de gauche",A remplir,19
1328,66,862,474,16,458,388,MN,2014,V,1,31,555,I,474,0,10,"A toulouse, place au peuple - front de gauche",A remplir,17
1329,96,978,542,17,525,436,MN,2014,V,1,31,555,I,542,0,10,"A toulouse, place au peuple - front de gauche",A remplir,54
1330,118,1142,631,12,619,511,MN,2014,V,1,31,555,I,631,0,10,"A toulouse, place au peuple - front de gauche",A remplir,23
1331,139,965,529,11,518,436,MN,2014,V,1,31,555,I,529,0,10,"A toulouse, place au peuple - front de gauche",A remplir,16
1332,141,957,569,8,561,388,MN,2014,V,1,31,555,I,569,0,10,"A toulouse, place au peuple - front de gauche",A remplir,18
1333,164,1183,491,16,475,692,MN,2014,V,1,31,555,I,491,0,10,"A toulouse, place au peuple - front de gauche",A remplir,31
1334,181,931,370,12,358,561,MN,2014,V,1,31,555,I,370,0,10,"A toulouse, place au peuple - front de gauche",A remplir,18
1335,211A,1286,623,28,595,663,MN,2014,V,1,31,555,I,623,0,10,"A toulouse, place au peuple - front de gauche",A remplir,35
1336,2,931,505,12,493,426,MN,2014,V,1,31,555,I,505,0,10,"A toulouse, place au peuple - front de gauche",A remplir,27
1337,9,941,528,3,525,413,MN,2014,V,1,31,555,I,528,0,10,"A toulouse, place au peuple - front de gauche",A remplir,35
1338,40,1276,595,11,584,681,MN,2014,V,1,31,555,I,595,0,10,"A toulouse, place au peuple - front de gauche",A remplir,17
1339,59,1038,581,10,571,457,MN,2014,V,1,31,555,I,581,0,10,"A toulouse, place au peuple - front de gauche",A remplir,28
1340,88,1122,596,12,584,526,MN,2014,V,1,31,555,I,596,0,10,"A toulouse, place au peuple - front de gauche",A remplir,26
1341,106,962,481,17,465,481,MN,2014,V,1,31,555,I,481,0,10,"A toulouse, place au peuple - front de gauche",A remplir,35
1342,120,1058,610,18,592,448,MN,2014,V,1,31,555,I,610,0,10,"A toulouse, place au peuple - front de gauche",A remplir,17
1343,145,1015,549,14,535,466,MN,2014,V,1,31,555,I,549,0,10,"A toulouse, place au peuple - front de gauche",A remplir,27
1344,149,1123,622,12,610,501,MN,2014,V,1,31,555,I,622,0,10,"A toulouse, place au peuple - front de gauche",A remplir,48
1345,201B,1032,580,19,561,452,MN,2014,V,1,31,555,I,580,0,10,"A toulouse, place au peuple - front de gauche",A remplir,20
1346,206,1087,549,20,529,538,MN,2014,V,1,31,555,I,549,0,10,"A toulouse, place au peuple - front de gauche",A remplir,26
1347,55,1082,614,14,600,468,MN,2014,V,1,31,555,I,614,0,10,"A toulouse, place au peuple - front de gauche",A remplir,36
1348,83,1176,712,10,702,464,MN,2014,V,1,31,555,I,712,0,10,"A toulouse, place au peuple - front de gauche",A remplir,31
1349,136,730,449,8,442,281,MN,2014,V,1,31,555,I,449,0,10,"A toulouse, place au peuple - front de gauche",A remplir,18
1350,158,1155,634,10,624,521,MN,2014,V,1,31,555,I,634,0,10,"A toulouse, place au peuple - front de gauche",A remplir,43
1351,162,1033,534,12,522,499,MN,2014,V,1,31,555,I,534,0,10,"A toulouse, place au peuple - front de gauche",A remplir,40
1352,170,819,446,8,438,373,MN,2014,V,1,31,555,I,446,0,10,"A toulouse, place au peuple - front de gauche",A remplir,24
1353,172,870,533,11,522,337,MN,2014,V,1,31,555,I,533,0,10,"A toulouse, place au peuple - front de gauche",A remplir,21
1354,222,1321,665,21,644,656,MN,2014,V,1,31,555,I,665,0,10,"A toulouse, place au peuple - front de gauche",A remplir,36
1355,7,928,450,9,441,478,MN,2014,V,1,31,555,I,450,0,10,"A toulouse, place au peuple - front de gauche",A remplir,22
1356,11,1115,633,14,620,482,MN,2014,V,1,31,555,I,633,0,10,"A toulouse, place au peuple - front de gauche",A remplir,36
1357,21,944,561,12,549,383,MN,2014,V,1,31,555,I,561,0,10,"A toulouse, place au peuple - front de gauche",A remplir,14
1358,53,1067,569,13,556,498,MN,2014,V,1,31,555,I,569,0,10,"A toulouse, place au peuple - front de gauche",A remplir,23
1359,122,1038,637,5,632,401,MN,2014,V,1,31,555,I,637,0,10,"A toulouse, place au peuple - front de gauche",A remplir,12
1360,124,1082,650,16,634,432,MN,2014,V,1,31,555,I,650,0,10,"A toulouse, place au peuple - front de gauche",A remplir,22
1361,129,990,483,16,467,507,MN,2014,V,1,31,555,I,483,0,10,"A toulouse, place au peuple - front de gauche",A remplir,24
1362,134,875,516,10,506,359,MN,2014,V,1,31,555,I,516,0,10,"A toulouse, place au peuple - front de gauche",A remplir,12
1363,135,1027,636,7,630,391,MN,2014,V,1,31,555,I,636,0,10,"A toulouse, place au peuple - front de gauche",A remplir,16
1364,175,995,320,11,309,675,MN,2014,V,1,31,555,I,320,0,10,"A toulouse, place au peuple - front de gauche",A remplir,17
1365,177,1084,439,24,415,645,MN,2014,V,1,31,555,I,439,0,10,"A toulouse, place au peuple - front de gauche",A remplir,15
1366,193,650,268,4,264,382,MN,2014,V,1,31,555,I,268,0,10,"A toulouse, place au peuple - front de gauche",A remplir,12
1367,199,503,252,4,248,251,MN,2014,V,1,31,555,I,252,0,10,"A toulouse, place au peuple - front de gauche",A remplir,5
1368,213,1101,583,17,566,518,MN,2014,V,1,31,555,I,583,0,10,"A toulouse, place au peuple - front de gauche",A remplir,34
1369,219,1138,614,10,604,524,MN,2014,V,1,31,555,I,614,0,10,"A toulouse, place au peuple - front de gauche",A remplir,26
1370,12,1116,608,12,596,508,MN,2014,V,1,31,555,I,608,0,10,"A toulouse, place au peuple - front de gauche",A remplir,17
1371,31,1020,561,8,553,459,MN,2014,V,1,31,555,I,561,0,10,"A toulouse, place au peuple - front de gauche",A remplir,13
1372,36,806,435,14,421,371,MN,2014,V,1,31,555,I,435,0,10,"A toulouse, place au peuple - front de gauche",A remplir,24
1373,46,986,558,11,547,428,MN,2014,V,1,31,555,I,558,0,10,"A toulouse, place au peuple - front de gauche",A remplir,30
1374,81,1177,499,16,483,678,MN,2014,V,1,31,555,I,499,0,10,"A toulouse, place au peuple - front de gauche",A remplir,33
1375,142,890,459,6,453,431,MN,2014,V,1,31,555,I,459,0,10,"A toulouse, place au peuple - front de gauche",A remplir,10
1376,152,944,355,14,341,589,MN,2014,V,1,31,555,I,355,0,10,"A toulouse, place au peuple - front de gauche",A remplir,31
1377,167,995,543,9,534,452,MN,2014,V,1,31,555,I,543,0,10,"A toulouse, place au peuple - front de gauche",A remplir,44
1378,190,1008,247,9,238,761,MN,2014,V,1,31,555,I,247,0,10,"A toulouse, place au peuple - front de gauche",A remplir,14
1379,225,838,451,16,435,387,MN,2014,V,1,31,555,I,451,0,10,"A toulouse, place au peuple - front de gauche",A remplir,23
1380,49,759,440,8,432,319,MN,2014,V,1,31,555,I,440,0,10,"A toulouse, place au peuple - front de gauche",A remplir,30
1381,50,977,533,16,517,444,MN,2014,V,1,31,555,I,533,0,10,"A toulouse, place au peuple - front de gauche",A remplir,31
1382,60,1164,611,25,586,553,MN,2014,V,1,31,555,I,611,0,10,"A toulouse, place au peuple - front de gauche",A remplir,31
1383,108A,939,523,13,510,416,MN,2014,V,1,31,555,I,523,0,10,"A toulouse, place au peuple - front de gauche",A remplir,28
1384,125,957,575,11,564,382,MN,2014,V,1,31,555,I,575,0,10,"A toulouse, place au peuple - front de gauche",A remplir,17
1385,182,794,435,10,425,359,MN,2014,V,1,31,555,I,435,0,10,"A toulouse, place au peuple - front de gauche",A remplir,25
1386,215,1373,629,18,611,744,MN,2014,V,1,31,555,I,629,0,10,"A toulouse, place au peuple - front de gauche",A remplir,41
1387,1,1100,541,10,532,559,MN,2014,V,1,31,555,I,541,0,10,"A toulouse, place au peuple - front de gauche",A remplir,26
1388,44,971,558,16,542,413,MN,2014,V,1,31,555,I,558,0,10,"A toulouse, place au peuple - front de gauche",A remplir,41
1389,49A,856,513,8,505,343,MN,2014,V,1,31,555,I,513,0,10,"A toulouse, place au peuple - front de gauche",A remplir,44
1390,165A,982,609,11,598,373,MN,2014,V,1,31,555,I,609,0,10,"A toulouse, place au peuple - front de gauche",A remplir,14
1391,200,1192,654,15,639,538,MN,2014,V,1,31,555,I,654,0,10,"A toulouse, place au peuple - front de gauche",A remplir,17
1392,5,772,439,10,429,333,MN,2014,V,1,31,555,I,439,0,10,"A toulouse, place au peuple - front de gauche",A remplir,14
1393,24,1061,543,8,535,518,MN,2014,V,1,31,555,I,543,0,10,"A toulouse, place au peuple - front de gauche",A remplir,34
1394,25A,1002,518,11,507,484,MN,2014,V,1,31,555,I,518,0,10,"A toulouse, place au peuple - front de gauche",A remplir,35
1395,51,1230,659,18,641,571,MN,2014,V,1,31,555,I,659,0,10,"A toulouse, place au peuple - front de gauche",A remplir,28
1396,71,941,513,10,504,428,MN,2014,V,1,31,555,I,513,0,10,"A toulouse, place au peuple - front de gauche",A remplir,36
1397,78,1006,624,19,605,382,MN,2014,V,1,31,555,I,624,0,10,"A toulouse, place au peuple - front de gauche",A remplir,29
1398,79,915,498,6,491,417,MN,2014,V,1,31,555,I,498,0,10,"A toulouse, place au peuple - front de gauche",A remplir,23
1399,80,1173,553,9,544,620,MN,2014,V,1,31,555,I,553,0,10,"A toulouse, place au peuple - front de gauche",A remplir,30
1400,97,1084,564,10,553,520,MN,2014,V,1,31,555,I,564,0,10,"A toulouse, place au peuple - front de gauche",A remplir,22
1401,184,1151,355,10,345,796,MN,2014,V,1,31,555,I,355,0,10,"A toulouse, place au peuple - front de gauche",A remplir,21
1402,188,1220,497,20,477,723,MN,2014,V,1,31,555,I,497,0,10,"A toulouse, place au peuple - front de gauche",A remplir,17
1403,8,891,480,13,467,411,MN,2014,V,1,31,555,I,480,0,10,"A toulouse, place au peuple - front de gauche",A remplir,19
1404,14,1014,595,6,589,419,MN,2014,V,1,31,555,I,595,0,10,"A toulouse, place au peuple - front de gauche",A remplir,38
1405,34,953,496,10,486,457,MN,2014,V,1,31,555,I,496,0,10,"A toulouse, place au peuple - front de gauche",A remplir,37
1406,39,1160,603,12,591,557,MN,2014,V,1,31,555,I,603,0,10,"A toulouse, place au peuple - front de gauche",A remplir,56
1407,63,806,314,6,308,492,MN,2014,V,1,31,555,I,314,0,10,"A toulouse, place au peuple - front de gauche",A remplir,16
1408,124A,982,582,15,567,400,MN,2014,V,1,31,555,I,582,0,10,"A toulouse, place au peuple - front de gauche",A remplir,11
1409,205,1184,651,18,633,533,MN,2014,V,1,31,555,I,651,0,10,"A toulouse, place au peuple - front de gauche",A remplir,27
1410,6,1098,531,11,520,567,MN,2014,V,1,31,555,I,531,0,10,"A toulouse, place au peuple - front de gauche",A remplir,32
1411,23,1205,614,7,607,591,MN,2014,V,1,31,555,I,614,0,10,"A toulouse, place au peuple - front de gauche",A remplir,39
1412,64,1233,675,22,653,558,MN,2014,V,1,31,555,I,675,0,10,"A toulouse, place au peuple - front de gauche",A remplir,23
1413,75,949,456,15,441,493,MN,2014,V,1,31,555,I,456,0,10,"A toulouse, place au peuple - front de gauche",A remplir,34
1414,76,1007,517,7,510,490,MN,2014,V,1,31,555,I,517,0,10,"A toulouse, place au peuple - front de gauche",A remplir,35
1415,111,956,511,10,501,445,MN,2014,V,1,31,555,I,511,0,10,"A toulouse, place au peuple - front de gauche",A remplir,16
1416,123,1134,589,8,581,545,MN,2014,V,1,31,555,I,589,0,10,"A toulouse, place au peuple - front de gauche",A remplir,26
1417,131,1051,602,12,590,449,MN,2014,V,1,31,555,I,602,0,10,"A toulouse, place au peuple - front de gauche",A remplir,36
1418,154,809,278,13,265,531,MN,2014,V,1,31,555,I,278,0,10,"A toulouse, place au peuple - front de gauche",A remplir,8
1419,179,709,357,9,348,352,MN,2014,V,1,31,555,I,357,0,10,"A toulouse, place au peuple - front de gauche",A remplir,25
1420,211,1377,732,18,714,645,MN,2014,V,1,31,555,I,732,0,10,"A toulouse, place au peuple - front de gauche",A remplir,35
1421,13,1041,588,11,577,453,MN,2014,V,1,31,555,I,588,0,10,"A toulouse, place au peuple - front de gauche",A remplir,34
1422,15,1078,643,10,633,435,MN,2014,V,1,31,555,I,643,0,10,"A toulouse, place au peuple - front de gauche",A remplir,37
1423,27,1122,647,10,637,475,MN,2014,V,1,31,555,I,647,0,10,"A toulouse, place au peuple - front de gauche",A remplir,20
1424,36A,1124,605,14,591,519,MN,2014,V,1,31,555,I,605,0,10,"A toulouse, place au peuple - front de gauche",A remplir,46
1425,56A,894,469,9,460,425,MN,2014,V,1,31,555,I,469,0,10,"A toulouse, place au peuple - front de gauche",A remplir,32
1426,69,1090,574,12,562,516,MN,2014,V,1,31,555,I,574,0,10,"A toulouse, place au peuple - front de gauche",A remplir,19
1427,113,1030,455,18,437,575,MN,2014,V,1,31,555,I,455,0,10,"A toulouse, place au peuple - front de gauche",A remplir,30
1428,147,1006,591,11,580,415,MN,2014,V,1,31,555,I,591,0,10,"A toulouse, place au peuple - front de gauche",A remplir,19
1429,165,1463,797,24,773,666,MN,2014,V,1,31,555,I,797,0,10,"A toulouse, place au peuple - front de gauche",A remplir,29
1430,201A,1154,711,21,690,443,MN,2014,V,1,31,555,I,711,0,10,"A toulouse, place au peuple - front de gauche",A remplir,19
1431,204,1153,587,18,569,566,MN,2014,V,1,31,555,I,587,0,10,"A toulouse, place au peuple - front de gauche",A remplir,28
1432,218,1264,701,15,686,563,MN,2014,V,1,31,555,I,701,0,10,"A toulouse, place au peuple - front de gauche",A remplir,31
1433,220,1242,685,19,666,557,MN,2014,V,1,31,555,I,685,0,10,"A toulouse, place au peuple - front de gauche",A remplir,36
1434,42,962,516,14,502,446,MN,2014,V,1,31,555,I,516,0,10,"A toulouse, place au peuple - front de gauche",A remplir,34
1435,58,1199,536,13,523,663,MN,2014,V,1,31,555,I,536,0,10,"A toulouse, place au peuple - front de gauche",A remplir,31
1436,95,1039,530,11,519,509,MN,2014,V,1,31,555,I,530,0,10,"A toulouse, place au peuple - front de gauche",A remplir,35
1437,116,1060,541,13,528,519,MN,2014,V,1,31,555,I,541,0,10,"A toulouse, place au peuple - front de gauche",A remplir,29
1438,151,983,544,9,535,439,MN,2014,V,1,31,555,I,544,0,10,"A toulouse, place au peuple - front de gauche",A remplir,29
1439,155,726,257,7,250,469,MN,2014,V,1,31,555,I,257,0,10,"A toulouse, place au peuple - front de gauche",A remplir,11
1440,198B,1072,625,17,608,447,MN,2014,V,1,31,555,I,625,0,10,"A toulouse, place au peuple - front de gauche",A remplir,25
1441,201,1015,630,10,620,385,MN,2014,V,1,31,555,I,630,0,10,"A toulouse, place au peuple - front de gauche",A remplir,16
1442,224,780,412,11,401,368,MN,2014,V,1,31,555,I,412,0,10,"A toulouse, place au peuple - front de gauche",A remplir,19
1443,17,940,535,10,525,405,MN,2014,V,1,31,555,I,535,0,10,"A toulouse, place au peuple - front de gauche",A remplir,30
1444,65,1142,646,19,627,496,MN,2014,V,1,31,555,I,646,0,10,"A toulouse, place au peuple - front de gauche",A remplir,34
1445,67,983,550,21,529,433,MN,2014,V,1,31,555,I,550,0,10,"A toulouse, place au peuple - front de gauche",A remplir,29
1446,102,739,369,8,361,370,MN,2014,V,1,31,555,I,369,0,10,"A toulouse, place au peuple - front de gauche",A remplir,29
1447,113A,976,526,13,513,450,MN,2014,V,1,31,555,I,526,0,10,"A toulouse, place au peuple - front de gauche",A remplir,28
1448,119,970,576,9,567,394,MN,2014,V,1,31,555,I,576,0,10,"A toulouse, place au peuple - front de gauche",A remplir,10
1449,191A,925,327,20,307,598,MN,2014,V,1,31,555,I,327,0,10,"A toulouse, place au peuple - front de gauche",A remplir,18
1450,198,1241,700,19,681,541,MN,2014,V,1,31,555,I,700,0,10,"A toulouse, place au peuple - front de gauche",A remplir,34
1451,208,1196,696,27,669,500,MN,2014,V,1,31,555,I,696,0,10,"A toulouse, place au peuple - front de gauche",A remplir,24
1452,32,848,516,8,508,332,MN,2014,V,1,31,555,I,516,0,10,"A toulouse, place au peuple - front de gauche",A remplir,13
1453,33,1059,631,17,614,428,MN,2014,V,1,31,555,I,631,0,10,"A toulouse, place au peuple - front de gauche",A remplir,43
1454,44B,805,394,16,378,411,MN,2014,V,1,31,555,I,394,0,10,"A toulouse, place au peuple - front de gauche",A remplir,16
1455,54,991,513,15,497,478,MN,2014,V,1,31,555,I,513,0,10,"A toulouse, place au peuple - front de gauche",A remplir,25
1456,92,1184,581,19,562,603,MN,2014,V,1,31,555,I,581,0,10,"A toulouse, place au peuple - front de gauche",A remplir,40
1457,93,1248,671,22,649,577,MN,2014,V,1,31,555,I,671,0,10,"A toulouse, place au peuple - front de gauche",A remplir,37
1458,108,1029,598,16,582,431,MN,2014,V,1,31,555,I,598,0,10,"A toulouse, place au peuple - front de gauche",A remplir,20
1459,138,889,558,15,543,331,MN,2014,V,1,31,555,I,558,0,10,"A toulouse, place au peuple - front de gauche",A remplir,22
1460,153,706,148,5,143,558,MN,2014,V,1,31,555,I,148,0,10,"A toulouse, place au peuple - front de gauche",A remplir,9
1461,163,1016,466,7,460,550,MN,2014,V,1,31,555,I,466,0,10,"A toulouse, place au peuple - front de gauche",A remplir,20
1462,191,1000,255,12,243,745,MN,2014,V,1,31,555,I,255,0,10,"A toulouse, place au peuple - front de gauche",A remplir,3
1463,197,994,590,20,570,404,MN,2014,V,1,31,555,I,590,0,10,"A toulouse, place au peuple - front de gauche",A remplir,33
1464,198A,955,556,15,541,399,MN,2014,V,1,31,555,I,556,0,10,"A toulouse, place au peuple - front de gauche",A remplir,25
1465,223,1190,637,21,616,553,MN,2014,V,1,31,555,I,637,0,10,"A toulouse, place au peuple - front de gauche",A remplir,17
1466,226,987,505,6,499,482,MN,2014,V,1,31,555,I,505,0,10,"A toulouse, place au peuple - front de gauche",A remplir,25
1467,37,890,465,15,450,425,MN,2014,V,1,31,555,I,465,0,10,"A toulouse, place au peuple - front de gauche",A remplir,29
1468,70,1004,580,14,566,424,MN,2014,V,1,31,555,I,580,0,10,"A toulouse, place au peuple - front de gauche",A remplir,20
1469,74,1059,538,7,531,521,MN,2014,V,1,31,555,I,538,0,10,"A toulouse, place au peuple - front de gauche",A remplir,19
1470,178,970,371,10,361,599,MN,2014,V,1,31,555,I,371,0,10,"A toulouse, place au peuple - front de gauche",A remplir,17
1471,10A,1006,494,11,483,512,MN,2014,V,1,31,555,I,494,0,10,"A toulouse, place au peuple - front de gauche",A remplir,31
1472,29,1159,606,9,598,553,MN,2014,V,1,31,555,I,606,0,10,"A toulouse, place au peuple - front de gauche",A remplir,19
1473,67A,929,482,11,471,447,MN,2014,V,1,31,555,I,482,0,10,"A toulouse, place au peuple - front de gauche",A remplir,30
1474,100,1027,479,9,470,548,MN,2014,V,1,31,555,I,479,0,10,"A toulouse, place au peuple - front de gauche",A remplir,39
1475,114,1108,530,15,515,578,MN,2014,V,1,31,555,I,530,0,10,"A toulouse, place au peuple - front de gauche",A remplir,29
1476,126,911,511,9,502,400,MN,2014,V,1,31,555,I,511,0,10,"A toulouse, place au peuple - front de gauche",A remplir,24
1477,130,1083,574,13,561,509,MN,2014,V,1,31,555,I,574,0,10,"A toulouse, place au peuple - front de gauche",A remplir,19
1478,161,967,524,11,513,443,MN,2014,V,1,31,555,I,524,0,10,"A toulouse, place au peuple - front de gauche",A remplir,25
1479,174,1101,559,8,551,542,MN,2014,V,1,31,555,I,559,0,10,"A toulouse, place au peuple - front de gauche",A remplir,38
1480,202,1197,556,19,537,641,MN,2014,V,1,31,555,I,556,0,10,"A toulouse, place au peuple - front de gauche",A remplir,22
1481,216,1186,583,17,566,603,MN,2014,V,1,31,555,I,583,0,10,"A toulouse, place au peuple - front de gauche",A remplir,37
1482,216A,1122,459,20,439,663,MN,2014,V,1,31,555,I,459,0,10,"A toulouse, place au peuple - front de gauche",A remplir,28
1483,20,1041,656,16,640,385,MN,2014,V,1,31,555,I,656,0,10,"A toulouse, place au peuple - front de gauche",A remplir,26
1484,38,975,516,18,498,459,MN,2014,V,1,31,555,I,516,0,10,"A toulouse, place au peuple - front de gauche",A remplir,33
1485,43,1026,583,21,562,443,MN,2014,V,1,31,555,I,583,0,10,"A toulouse, place au peuple - front de gauche",A remplir,40
1486,133,983,556,15,541,427,MN,2014,V,1,31,555,I,556,0,10,"A toulouse, place au peuple - front de gauche",A remplir,17
1487,138A,951,606,17,589,345,MN,2014,V,1,31,555,I,606,0,10,"A toulouse, place au peuple - front de gauche",A remplir,33
1488,143,984,592,9,583,392,MN,2014,V,1,31,555,I,592,0,10,"A toulouse, place au peuple - front de gauche",A remplir,17
1489,160,1056,563,10,553,493,MN,2014,V,1,31,555,I,563,0,10,"A toulouse, place au peuple - front de gauche",A remplir,17
1490,180,755,275,2,273,480,MN,2014,V,1,31,555,I,275,0,10,"A toulouse, place au peuple - front de gauche",A remplir,15
1491,195B,1078,677,18,659,401,MN,2014,V,1,31,555,I,677,0,10,"A toulouse, place au peuple - front de gauche",A remplir,51
1492,196,1165,666,15,651,499,MN,2014,V,1,31,555,I,666,0,10,"A toulouse, place au peuple - front de gauche",A remplir,25
1493,217,1275,630,18,612,645,MN,2014,V,1,31,555,I,630,0,10,"A toulouse, place au peuple - front de gauche",A remplir,33
1494,28,1074,561,7,554,513,MN,2014,V,1,31,555,I,561,0,10,Aimer toulouse,A remplir,9
1495,41,975,548,11,537,427,MN,2014,V,1,31,555,I,548,0,10,Aimer toulouse,A remplir,14
1496,72,1046,510,5,505,536,MN,2014,V,1,31,555,I,510,0,10,Aimer toulouse,A remplir,3
1497,105,961,472,16,456,489,MN,2014,V,1,31,555,I,472,0,10,Aimer toulouse,A remplir,17
1498,109,1098,619,15,604,479,MN,2014,V,1,31,555,I,619,0,10,Aimer toulouse,A remplir,19
1499,117,1119,551,9,542,568,MN,2014,V,1,31,555,I,551,0,10,Aimer toulouse,A remplir,7
1500,121,1065,621,6,615,444,MN,2014,V,1,31,555,I,621,0,10,Aimer toulouse,A remplir,18
1501,171,1072,450,13,437,622,MN,2014,V,1,31,555,I,450,0,10,Aimer toulouse,A remplir,7
1502,174A,1093,484,9,475,609,MN,2014,V,1,31,555,I,484,0,10,Aimer toulouse,A remplir,8
1503,192,698,315,9,306,383,MN,2014,V,1,31,555,I,315,0,10,Aimer toulouse,A remplir,7
1504,194,863,405,15,390,458,MN,2014,V,1,31,555,I,405,0,10,Aimer toulouse,A remplir,8
1505,214,1312,659,16,643,653,MN,2014,V,1,31,555,I,659,0,10,Aimer toulouse,A remplir,13
1506,3,919,501,10,491,418,MN,2014,V,1,31,555,I,501,0,10,Aimer toulouse,A remplir,8
1507,44A,1061,529,19,510,532,MN,2014,V,1,31,555,I,529,0,10,Aimer toulouse,A remplir,17
1508,47,1034,588,11,577,446,MN,2014,V,1,31,555,I,588,0,10,Aimer toulouse,A remplir,5
1509,62,1049,498,12,486,551,MN,2014,V,1,31,555,I,498,0,10,Aimer toulouse,A remplir,13
1510,82,976,490,12,478,486,MN,2014,V,1,31,555,I,490,0,10,Aimer toulouse,A remplir,11
1511,86,1070,542,8,534,528,MN,2014,V,1,31,555,I,542,0,10,Aimer toulouse,A remplir,11
1512,127,908,537,9,528,371,MN,2014,V,1,31,555,I,537,0,10,Aimer toulouse,A remplir,11
1513,156,889,425,11,414,464,MN,2014,V,1,31,555,I,425,0,10,Aimer toulouse,A remplir,12
1514,159,1232,667,12,655,565,MN,2014,V,1,31,555,I,667,0,10,Aimer toulouse,A remplir,12
1515,169,953,362,11,351,591,MN,2014,V,1,31,555,I,362,0,10,Aimer toulouse,A remplir,2
1516,173,962,388,8,380,574,MN,2014,V,1,31,555,I,388,0,10,Aimer toulouse,A remplir,6
1517,203,848,421,16,405,427,MN,2014,V,1,31,555,I,421,0,10,Aimer toulouse,A remplir,9
1518,203B,1049,585,16,569,464,MN,2014,V,1,31,555,I,585,0,10,Aimer toulouse,A remplir,10
1519,18,1208,703,23,680,505,MN,2014,V,1,31,555,I,703,0,10,Aimer toulouse,A remplir,13
1520,48,1004,509,11,498,495,MN,2014,V,1,31,555,I,509,0,10,Aimer toulouse,A remplir,11
1521,57,882,517,18,499,365,MN,2014,V,1,31,555,I,517,0,10,Aimer toulouse,A remplir,9
1522,68,1002,582,23,559,420,MN,2014,V,1,31,555,I,582,0,10,Aimer toulouse,A remplir,12
1523,128,1114,576,22,554,538,MN,2014,V,1,31,555,I,576,0,10,Aimer toulouse,A remplir,12
1524,137,995,617,10,607,378,MN,2014,V,1,31,555,I,617,0,10,Aimer toulouse,A remplir,7
1525,144A,992,563,13,551,429,MN,2014,V,1,31,555,I,563,0,10,Aimer toulouse,A remplir,11
1526,157,1208,645,11,634,563,MN,2014,V,1,31,555,I,645,0,10,Aimer toulouse,A remplir,11
1527,166,1147,666,12,653,481,MN,2014,V,1,31,555,I,666,0,10,Aimer toulouse,A remplir,8
1528,195,811,443,7,436,368,MN,2014,V,1,31,555,I,443,0,10,Aimer toulouse,A remplir,7
1529,200A,1064,537,13,524,527,MN,2014,V,1,31,555,I,537,0,10,Aimer toulouse,A remplir,15
1530,203A,817,451,6,445,366,MN,2014,V,1,31,555,I,451,0,10,Aimer toulouse,A remplir,10
1531,35,1057,526,10,516,531,MN,2014,V,1,31,555,I,526,0,10,Aimer toulouse,A remplir,10
1532,45,1038,429,8,421,609,MN,2014,V,1,31,555,I,429,0,10,Aimer toulouse,A remplir,9
1533,61,859,467,16,451,392,MN,2014,V,1,31,555,I,467,0,10,Aimer toulouse,A remplir,8
1534,94,1110,641,11,630,469,MN,2014,V,1,31,555,I,641,0,10,Aimer toulouse,A remplir,24
1535,107,1019,581,8,573,438,MN,2014,V,1,31,555,I,581,0,10,Aimer toulouse,A remplir,9
1536,110,918,502,13,489,416,MN,2014,V,1,31,555,I,502,0,10,Aimer toulouse,A remplir,7
1537,134A,1406,745,22,723,661,MN,2014,V,1,31,555,I,745,0,10,Aimer toulouse,A remplir,13
1538,146,833,440,3,437,393,MN,2014,V,1,31,555,I,440,0,10,Aimer toulouse,A remplir,10
1539,186,1299,322,18,304,977,MN,2014,V,1,31,555,I,322,0,10,Aimer toulouse,A remplir,2
1540,195A,1090,474,13,461,616,MN,2014,V,1,31,555,I,474,0,10,Aimer toulouse,A remplir,7
1541,16,947,558,10,548,389,MN,2014,V,1,31,555,I,558,0,10,Aimer toulouse,A remplir,15
1542,39A,938,525,28,497,413,MN,2014,V,1,31,555,I,525,0,10,Aimer toulouse,A remplir,12
1543,85,994,452,13,439,542,MN,2014,V,1,31,555,I,452,0,10,Aimer toulouse,A remplir,7
1544,87,1204,619,8,612,585,MN,2014,V,1,31,555,I,619,0,10,Aimer toulouse,A remplir,28
1545,93B,1235,656,16,640,579,MN,2014,V,1,31,555,I,656,0,10,Aimer toulouse,A remplir,21
1546,101,1126,627,10,617,499,MN,2014,V,1,31,555,I,627,0,10,Aimer toulouse,A remplir,24
1547,104,1042,609,21,588,433,MN,2014,V,1,31,555,I,609,0,10,Aimer toulouse,A remplir,16
1548,112,841,429,10,419,412,MN,2014,V,1,31,555,I,429,0,10,Aimer toulouse,A remplir,11
1549,148,830,418,14,404,412,MN,2014,V,1,31,555,I,418,0,10,Aimer toulouse,A remplir,8
1550,207,1141,602,18,584,539,MN,2014,V,1,31,555,I,602,0,10,Aimer toulouse,A remplir,18
1551,210,1252,597,16,581,655,MN,2014,V,1,31,555,I,597,0,10,Aimer toulouse,A remplir,19
1552,10,979,521,13,508,458,MN,2014,V,1,31,555,I,521,0,10,Aimer toulouse,A remplir,7
1553,77,976,544,9,535,432,MN,2014,V,1,31,555,I,544,0,10,Aimer toulouse,A remplir,6
1554,91,1000,523,15,508,477,MN,2014,V,1,31,555,I,523,0,10,Aimer toulouse,A remplir,21
1555,132,1073,553,5,548,520,MN,2014,V,1,31,555,I,553,0,10,Aimer toulouse,A remplir,7
1556,189,832,311,8,303,521,MN,2014,V,1,31,555,I,311,0,10,Aimer toulouse,A remplir,11
1557,193A,795,360,9,351,435,MN,2014,V,1,31,555,I,360,0,10,Aimer toulouse,A remplir,9
1558,209,1102,507,22,485,595,MN,2014,V,1,31,555,I,507,0,10,Aimer toulouse,A remplir,7
1559,212,442,187,4,183,255,MN,2014,V,1,31,555,I,187,0,10,Aimer toulouse,A remplir,2
1560,4,956,571,10,561,385,MN,2014,V,1,31,555,I,571,0,10,Aimer toulouse,A remplir,8
1561,19,1084,637,8,631,447,MN,2014,V,1,31,555,I,637,0,10,Aimer toulouse,A remplir,21
1562,30,992,554,7,547,438,MN,2014,V,1,31,555,I,554,0,10,Aimer toulouse,A remplir,5
1563,56,1025,487,8,479,538,MN,2014,V,1,31,555,I,487,0,10,Aimer toulouse,A remplir,6
1564,84,1173,642,7,635,531,MN,2014,V,1,31,555,I,642,0,10,Aimer toulouse,A remplir,4
1565,93A,1276,661,14,647,615,MN,2014,V,1,31,555,I,661,0,10,Aimer toulouse,A remplir,15
1566,144,991,611,13,598,380,MN,2014,V,1,31,555,I,611,0,10,Aimer toulouse,A remplir,11
1567,22,1086,605,16,589,481,MN,2014,V,1,31,555,I,605,0,10,Aimer toulouse,A remplir,12
1568,25,1083,547,7,540,536,MN,2014,V,1,31,555,I,547,0,10,Aimer toulouse,A remplir,8
1569,73,1069,531,13,518,538,MN,2014,V,1,31,555,I,531,0,10,Aimer toulouse,A remplir,7
1570,99,933,486,11,475,447,MN,2014,V,1,31,555,I,486,0,10,Aimer toulouse,A remplir,28
1571,103,871,459,18,441,412,MN,2014,V,1,31,555,I,459,0,10,Aimer toulouse,A remplir,23
1572,140,935,559,9,550,376,MN,2014,V,1,31,555,I,559,0,10,Aimer toulouse,A remplir,12
1573,150,1022,574,6,568,448,MN,2014,V,1,31,555,I,574,0,10,Aimer toulouse,A remplir,9
1574,168,934,464,17,447,470,MN,2014,V,1,31,555,I,464,0,10,Aimer toulouse,A remplir,9
1575,22A,1047,587,16,571,460,MN,2014,V,1,31,555,I,587,0,10,Aimer toulouse,A remplir,11
1576,52,1066,539,12,527,527,MN,2014,V,1,31,555,I,539,0,10,Aimer toulouse,A remplir,19
1577,66,862,474,16,458,388,MN,2014,V,1,31,555,I,474,0,10,Aimer toulouse,A remplir,8
1578,96,978,542,17,525,436,MN,2014,V,1,31,555,I,542,0,10,Aimer toulouse,A remplir,20
1579,118,1142,631,12,619,511,MN,2014,V,1,31,555,I,631,0,10,Aimer toulouse,A remplir,5
1580,139,965,529,11,518,436,MN,2014,V,1,31,555,I,529,0,10,Aimer toulouse,A remplir,14
1581,141,957,569,8,561,388,MN,2014,V,1,31,555,I,569,0,10,Aimer toulouse,A remplir,15
1582,164,1183,491,16,475,692,MN,2014,V,1,31,555,I,491,0,10,Aimer toulouse,A remplir,11
1583,181,931,370,12,358,561,MN,2014,V,1,31,555,I,370,0,10,Aimer toulouse,A remplir,5
1584,211A,1286,623,28,595,663,MN,2014,V,1,31,555,I,623,0,10,Aimer toulouse,A remplir,13
1585,2,931,505,12,493,426,MN,2014,V,1,31,555,I,505,0,10,Aimer toulouse,A remplir,12
1586,9,941,528,3,525,413,MN,2014,V,1,31,555,I,528,0,10,Aimer toulouse,A remplir,5
1587,40,1276,595,11,584,681,MN,2014,V,1,31,555,I,595,0,10,Aimer toulouse,A remplir,12
1588,59,1038,581,10,571,457,MN,2014,V,1,31,555,I,581,0,10,Aimer toulouse,A remplir,11
1589,88,1122,596,12,584,526,MN,2014,V,1,31,555,I,596,0,10,Aimer toulouse,A remplir,28
1590,106,962,481,17,465,481,MN,2014,V,1,31,555,I,481,0,10,Aimer toulouse,A remplir,12
1591,120,1058,610,18,592,448,MN,2014,V,1,31,555,I,610,0,10,Aimer toulouse,A remplir,15
1592,145,1015,549,14,535,466,MN,2014,V,1,31,555,I,549,0,10,Aimer toulouse,A remplir,5
1593,149,1123,622,12,610,501,MN,2014,V,1,31,555,I,622,0,10,Aimer toulouse,A remplir,6
1594,201B,1032,580,19,561,452,MN,2014,V,1,31,555,I,580,0,10,Aimer toulouse,A remplir,19
1595,206,1087,549,20,529,538,MN,2014,V,1,31,555,I,549,0,10,Aimer toulouse,A remplir,19
1596,55,1082,614,14,600,468,MN,2014,V,1,31,555,I,614,0,10,Aimer toulouse,A remplir,11
1597,83,1176,712,10,702,464,MN,2014,V,1,31,555,I,712,0,10,Aimer toulouse,A remplir,11
1598,136,730,449,8,442,281,MN,2014,V,1,31,555,I,449,0,10,Aimer toulouse,A remplir,3
1599,158,1155,634,10,624,521,MN,2014,V,1,31,555,I,634,0,10,Aimer toulouse,A remplir,15
1600,162,1033,534,12,522,499,MN,2014,V,1,31,555,I,534,0,10,Aimer toulouse,A remplir,8
1601,170,819,446,8,438,373,MN,2014,V,1,31,555,I,446,0,10,Aimer toulouse,A remplir,5
1602,172,870,533,11,522,337,MN,2014,V,1,31,555,I,533,0,10,Aimer toulouse,A remplir,6
1603,222,1321,665,21,644,656,MN,2014,V,1,31,555,I,665,0,10,Aimer toulouse,A remplir,23
1604,7,928,450,9,441,478,MN,2014,V,1,31,555,I,450,0,10,Aimer toulouse,A remplir,5
1605,11,1115,633,14,620,482,MN,2014,V,1,31,555,I,633,0,10,Aimer toulouse,A remplir,8
1606,21,944,561,12,549,383,MN,2014,V,1,31,555,I,561,0,10,Aimer toulouse,A remplir,11
1607,53,1067,569,13,556,498,MN,2014,V,1,31,555,I,569,0,10,Aimer toulouse,A remplir,14
1608,122,1038,637,5,632,401,MN,2014,V,1,31,555,I,637,0,10,Aimer toulouse,A remplir,11
1609,124,1082,650,16,634,432,MN,2014,V,1,31,555,I,650,0,10,Aimer toulouse,A remplir,9
1610,129,990,483,16,467,507,MN,2014,V,1,31,555,I,483,0,10,Aimer toulouse,A remplir,8
1611,134,875,516,10,506,359,MN,2014,V,1,31,555,I,516,0,10,Aimer toulouse,A remplir,13
1612,135,1027,636,7,630,391,MN,2014,V,1,31,555,I,636,0,10,Aimer toulouse,A remplir,15
1613,175,995,320,11,309,675,MN,2014,V,1,31,555,I,320,0,10,Aimer toulouse,A remplir,2
1614,177,1084,439,24,415,645,MN,2014,V,1,31,555,I,439,0,10,Aimer toulouse,A remplir,9
1615,193,650,268,4,264,382,MN,2014,V,1,31,555,I,268,0,10,Aimer toulouse,A remplir,2
1616,199,503,252,4,248,251,MN,2014,V,1,31,555,I,252,0,10,Aimer toulouse,A remplir,5
1617,213,1101,583,17,566,518,MN,2014,V,1,31,555,I,583,0,10,Aimer toulouse,A remplir,9
1618,219,1138,614,10,604,524,MN,2014,V,1,31,555,I,614,0,10,Aimer toulouse,A remplir,14
1619,12,1116,608,12,596,508,MN,2014,V,1,31,555,I,608,0,10,Aimer toulouse,A remplir,7
1620,31,1020,561,8,553,459,MN,2014,V,1,31,555,I,561,0,10,Aimer toulouse,A remplir,9
1621,36,806,435,14,421,371,MN,2014,V,1,31,555,I,435,0,10,Aimer toulouse,A remplir,15
1622,46,986,558,11,547,428,MN,2014,V,1,31,555,I,558,0,10,Aimer toulouse,A remplir,8
1623,81,1177,499,16,483,678,MN,2014,V,1,31,555,I,499,0,10,Aimer toulouse,A remplir,9
1624,142,890,459,6,453,431,MN,2014,V,1,31,555,I,459,0,10,Aimer toulouse,A remplir,6
1625,152,944,355,14,341,589,MN,2014,V,1,31,555,I,355,0,10,Aimer toulouse,A remplir,3
1626,167,995,543,9,534,452,MN,2014,V,1,31,555,I,543,0,10,Aimer toulouse,A remplir,11
1627,190,1008,247,9,238,761,MN,2014,V,1,31,555,I,247,0,10,Aimer toulouse,A remplir,2
1628,225,838,451,16,435,387,MN,2014,V,1,31,555,I,451,0,10,Aimer toulouse,A remplir,15
1629,49,759,440,8,432,319,MN,2014,V,1,31,555,I,440,0,10,Aimer toulouse,A remplir,4
1630,50,977,533,16,517,444,MN,2014,V,1,31,555,I,533,0,10,Aimer toulouse,A remplir,14
1631,60,1164,611,25,586,553,MN,2014,V,1,31,555,I,611,0,10,Aimer toulouse,A remplir,9
1632,108A,939,523,13,510,416,MN,2014,V,1,31,555,I,523,0,10,Aimer toulouse,A remplir,6
1633,125,957,575,11,564,382,MN,2014,V,1,31,555,I,575,0,10,Aimer toulouse,A remplir,16
1634,182,794,435,10,425,359,MN,2014,V,1,31,555,I,435,0,10,Aimer toulouse,A remplir,9
1635,215,1373,629,18,611,744,MN,2014,V,1,31,555,I,629,0,10,Aimer toulouse,A remplir,23
1636,1,1100,541,10,532,559,MN,2014,V,1,31,555,I,541,0,10,Aimer toulouse,A remplir,3
1637,44,971,558,16,542,413,MN,2014,V,1,31,555,I,558,0,10,Aimer toulouse,A remplir,18
1638,49A,856,513,8,505,343,MN,2014,V,1,31,555,I,513,0,10,Aimer toulouse,A remplir,9
1639,165A,982,609,11,598,373,MN,2014,V,1,31,555,I,609,0,10,Aimer toulouse,A remplir,14
1640,200,1192,654,15,639,538,MN,2014,V,1,31,555,I,654,0,10,Aimer toulouse,A remplir,24
1641,5,772,439,10,429,333,MN,2014,V,1,31,555,I,439,0,10,Aimer toulouse,A remplir,4
1642,24,1061,543,8,535,518,MN,2014,V,1,31,555,I,543,0,10,Aimer toulouse,A remplir,8
1643,25A,1002,518,11,507,484,MN,2014,V,1,31,555,I,518,0,10,Aimer toulouse,A remplir,4
1644,51,1230,659,18,641,571,MN,2014,V,1,31,555,I,659,0,10,Aimer toulouse,A remplir,22
1645,71,941,513,10,504,428,MN,2014,V,1,31,555,I,513,0,10,Aimer toulouse,A remplir,8
1646,78,1006,624,19,605,382,MN,2014,V,1,31,555,I,624,0,10,Aimer toulouse,A remplir,7
1647,79,915,498,6,491,417,MN,2014,V,1,31,555,I,498,0,10,Aimer toulouse,A remplir,6
1648,80,1173,553,9,544,620,MN,2014,V,1,31,555,I,553,0,10,Aimer toulouse,A remplir,7
1649,97,1084,564,10,553,520,MN,2014,V,1,31,555,I,564,0,10,Aimer toulouse,A remplir,23
1650,184,1151,355,10,345,796,MN,2014,V,1,31,555,I,355,0,10,Aimer toulouse,A remplir,15
1651,188,1220,497,20,477,723,MN,2014,V,1,31,555,I,497,0,10,Aimer toulouse,A remplir,11
1652,8,891,480,13,467,411,MN,2014,V,1,31,555,I,480,0,10,Aimer toulouse,A remplir,17
1653,14,1014,595,6,589,419,MN,2014,V,1,31,555,I,595,0,10,Aimer toulouse,A remplir,15
1654,34,953,496,10,486,457,MN,2014,V,1,31,555,I,496,0,10,Aimer toulouse,A remplir,11
1655,39,1160,603,12,591,557,MN,2014,V,1,31,555,I,603,0,10,Aimer toulouse,A remplir,17
1656,63,806,314,6,308,492,MN,2014,V,1,31,555,I,314,0,10,Aimer toulouse,A remplir,8
1657,124A,982,582,15,567,400,MN,2014,V,1,31,555,I,582,0,10,Aimer toulouse,A remplir,6
1658,205,1184,651,18,633,533,MN,2014,V,1,31,555,I,651,0,10,Aimer toulouse,A remplir,10
1659,6,1098,531,11,520,567,MN,2014,V,1,31,555,I,531,0,10,Aimer toulouse,A remplir,8
1660,23,1205,614,7,607,591,MN,2014,V,1,31,555,I,614,0,10,Aimer toulouse,A remplir,10
1661,64,1233,675,22,653,558,MN,2014,V,1,31,555,I,675,0,10,Aimer toulouse,A remplir,20
1662,75,949,456,15,441,493,MN,2014,V,1,31,555,I,456,0,10,Aimer toulouse,A remplir,7
1663,76,1007,517,7,510,490,MN,2014,V,1,31,555,I,517,0,10,Aimer toulouse,A remplir,12
1664,111,956,511,10,501,445,MN,2014,V,1,31,555,I,511,0,10,Aimer toulouse,A remplir,9
1665,123,1134,589,8,581,545,MN,2014,V,1,31,555,I,589,0,10,Aimer toulouse,A remplir,13
1666,131,1051,602,12,590,449,MN,2014,V,1,31,555,I,602,0,10,Aimer toulouse,A remplir,7
1667,154,809,278,13,265,531,MN,2014,V,1,31,555,I,278,0,10,Aimer toulouse,A remplir,3
1668,179,709,357,9,348,352,MN,2014,V,1,31,555,I,357,0,10,Aimer toulouse,A remplir,5
1669,211,1377,732,18,714,645,MN,2014,V,1,31,555,I,732,0,10,Aimer toulouse,A remplir,23
1670,13,1041,588,11,577,453,MN,2014,V,1,31,555,I,588,0,10,Aimer toulouse,A remplir,11
1671,15,1078,643,10,633,435,MN,2014,V,1,31,555,I,643,0,10,Aimer toulouse,A remplir,11
1672,27,1122,647,10,637,475,MN,2014,V,1,31,555,I,647,0,10,Aimer toulouse,A remplir,9
1673,36A,1124,605,14,591,519,MN,2014,V,1,31,555,I,605,0,10,Aimer toulouse,A remplir,12
1674,56A,894,469,9,460,425,MN,2014,V,1,31,555,I,469,0,10,Aimer toulouse,A remplir,9
1675,69,1090,574,12,562,516,MN,2014,V,1,31,555,I,574,0,10,Aimer toulouse,A remplir,26
1676,113,1030,455,18,437,575,MN,2014,V,1,31,555,I,455,0,10,Aimer toulouse,A remplir,8
1677,147,1006,591,11,580,415,MN,2014,V,1,31,555,I,591,0,10,Aimer toulouse,A remplir,5
1678,165,1463,797,24,773,666,MN,2014,V,1,31,555,I,797,0,10,Aimer toulouse,A remplir,20
1679,201A,1154,711,21,690,443,MN,2014,V,1,31,555,I,711,0,10,Aimer toulouse,A remplir,17
1680,204,1153,587,18,569,566,MN,2014,V,1,31,555,I,587,0,10,Aimer toulouse,A remplir,14
1681,218,1264,701,15,686,563,MN,2014,V,1,31,555,I,701,0,10,Aimer toulouse,A remplir,15
1682,220,1242,685,19,666,557,MN,2014,V,1,31,555,I,685,0,10,Aimer toulouse,A remplir,12
1683,42,962,516,14,502,446,MN,2014,V,1,31,555,I,516,0,10,Aimer toulouse,A remplir,18
1684,58,1199,536,13,523,663,MN,2014,V,1,31,555,I,536,0,10,Aimer toulouse,A remplir,7
1685,95,1039,530,11,519,509,MN,2014,V,1,31,555,I,530,0,10,Aimer toulouse,A remplir,16
1686,116,1060,541,13,528,519,MN,2014,V,1,31,555,I,541,0,10,Aimer toulouse,A remplir,12
1687,151,983,544,9,535,439,MN,2014,V,1,31,555,I,544,0,10,Aimer toulouse,A remplir,14
1688,155,726,257,7,250,469,MN,2014,V,1,31,555,I,257,0,10,Aimer toulouse,A remplir,5
1689,198B,1072,625,17,608,447,MN,2014,V,1,31,555,I,625,0,10,Aimer toulouse,A remplir,20
1690,201,1015,630,10,620,385,MN,2014,V,1,31,555,I,630,0,10,Aimer toulouse,A remplir,10
1691,224,780,412,11,401,368,MN,2014,V,1,31,555,I,412,0,10,Aimer toulouse,A remplir,5
1692,17,940,535,10,525,405,MN,2014,V,1,31,555,I,535,0,10,Aimer toulouse,A remplir,12
1693,65,1142,646,19,627,496,MN,2014,V,1,31,555,I,646,0,10,Aimer toulouse,A remplir,14
1694,67,983,550,21,529,433,MN,2014,V,1,31,555,I,550,0,10,Aimer toulouse,A remplir,9
1695,102,739,369,8,361,370,MN,2014,V,1,31,555,I,369,0,10,Aimer toulouse,A remplir,4
1696,113A,976,526,13,513,450,MN,2014,V,1,31,555,I,526,0,10,Aimer toulouse,A remplir,14
1697,119,970,576,9,567,394,MN,2014,V,1,31,555,I,576,0,10,Aimer toulouse,A remplir,7
1698,191A,925,327,20,307,598,MN,2014,V,1,31,555,I,327,0,10,Aimer toulouse,A remplir,11
1699,198,1241,700,19,681,541,MN,2014,V,1,31,555,I,700,0,10,Aimer toulouse,A remplir,22
1700,208,1196,696,27,669,500,MN,2014,V,1,31,555,I,696,0,10,Aimer toulouse,A remplir,12
1701,32,848,516,8,508,332,MN,2014,V,1,31,555,I,516,0,10,Aimer toulouse,A remplir,7
1702,33,1059,631,17,614,428,MN,2014,V,1,31,555,I,631,0,10,Aimer toulouse,A remplir,7
1703,44B,805,394,16,378,411,MN,2014,V,1,31,555,I,394,0,10,Aimer toulouse,A remplir,11
1704,54,991,513,15,497,478,MN,2014,V,1,31,555,I,513,0,10,Aimer toulouse,A remplir,12
1705,92,1184,581,19,562,603,MN,2014,V,1,31,555,I,581,0,10,Aimer toulouse,A remplir,14
1706,93,1248,671,22,649,577,MN,2014,V,1,31,555,I,671,0,10,Aimer toulouse,A remplir,11
1707,108,1029,598,16,582,431,MN,2014,V,1,31,555,I,598,0,10,Aimer toulouse,A remplir,12
1708,138,889,558,15,543,331,MN,2014,V,1,31,555,I,558,0,10,Aimer toulouse,A remplir,7
1709,153,706,148,5,143,558,MN,2014,V,1,31,555,I,148,0,10,Aimer toulouse,A remplir,1
1710,163,1016,466,7,460,550,MN,2014,V,1,31,555,I,466,0,10,Aimer toulouse,A remplir,11
1711,191,1000,255,12,243,745,MN,2014,V,1,31,555,I,255,0,10,Aimer toulouse,A remplir,9
1712,197,994,590,20,570,404,MN,2014,V,1,31,555,I,590,0,10,Aimer toulouse,A remplir,12
1713,198A,955,556,15,541,399,MN,2014,V,1,31,555,I,556,0,10,Aimer toulouse,A remplir,11
1714,223,1190,637,21,616,553,MN,2014,V,1,31,555,I,637,0,10,Aimer toulouse,A remplir,18
1715,226,987,505,6,499,482,MN,2014,V,1,31,555,I,505,0,10,Aimer toulouse,A remplir,16
1716,37,890,465,15,450,425,MN,2014,V,1,31,555,I,465,0,10,Aimer toulouse,A remplir,9
1717,70,1004,580,14,566,424,MN,2014,V,1,31,555,I,580,0,10,Aimer toulouse,A remplir,12
1718,74,1059,538,7,531,521,MN,2014,V,1,31,555,I,538,0,10,Aimer toulouse,A remplir,8
1719,178,970,371,10,361,599,MN,2014,V,1,31,555,I,371,0,10,Aimer toulouse,A remplir,2
1720,10A,1006,494,11,483,512,MN,2014,V,1,31,555,I,494,0,10,Aimer toulouse,A remplir,11
1721,29,1159,606,9,598,553,MN,2014,V,1,31,555,I,606,0,10,Aimer toulouse,A remplir,17
1722,67A,929,482,11,471,447,MN,2014,V,1,31,555,I,482,0,10,Aimer toulouse,A remplir,9
1723,100,1027,479,9,470,548,MN,2014,V,1,31,555,I,479,0,10,Aimer toulouse,A remplir,9
1724,114,1108,530,15,515,578,MN,2014,V,1,31,555,I,530,0,10,Aimer toulouse,A remplir,7
1725,126,911,511,9,502,400,MN,2014,V,1,31,555,I,511,0,10,Aimer toulouse,A remplir,7
1726,130,1083,574,13,561,509,MN,2014,V,1,31,555,I,574,0,10,Aimer toulouse,A remplir,12
1727,161,967,524,11,513,443,MN,2014,V,1,31,555,I,524,0,10,Aimer toulouse,A remplir,6
1728,174,1101,559,8,551,542,MN,2014,V,1,31,555,I,559,0,10,Aimer toulouse,A remplir,8
1729,202,1197,556,19,537,641,MN,2014,V,1,31,555,I,556,0,10,Aimer toulouse,A remplir,10
1730,216,1186,583,17,566,603,MN,2014,V,1,31,555,I,583,0,10,Aimer toulouse,A remplir,12
1731,216A,1122,459,20,439,663,MN,2014,V,1,31,555,I,459,0,10,Aimer toulouse,A remplir,9
1732,20,1041,656,16,640,385,MN,2014,V,1,31,555,I,656,0,10,Aimer toulouse,A remplir,16
1733,38,975,516,18,498,459,MN,2014,V,1,31,555,I,516,0,10,Aimer toulouse,A remplir,8
1734,43,1026,583,21,562,443,MN,2014,V,1,31,555,I,583,0,10,Aimer toulouse,A remplir,10
1735,133,983,556,15,541,427,MN,2014,V,1,31,555,I,556,0,10,Aimer toulouse,A remplir,8
1736,138A,951,606,17,589,345,MN,2014,V,1,31,555,I,606,0,10,Aimer toulouse,A remplir,6
1737,143,984,592,9,583,392,MN,2014,V,1,31,555,I,592,0,10,Aimer toulouse,A remplir,9
1738,160,1056,563,10,553,493,MN,2014,V,1,31,555,I,563,0,10,Aimer toulouse,A remplir,16
1739,180,755,275,2,273,480,MN,2014,V,1,31,555,I,275,0,10,Aimer toulouse,A remplir,5
1740,195B,1078,677,18,659,401,MN,2014,V,1,31,555,I,677,0,10,Aimer toulouse,A remplir,8
1741,196,1165,666,15,651,499,MN,2014,V,1,31,555,I,666,0,10,Aimer toulouse,A remplir,17
1742,217,1275,630,18,612,645,MN,2014,V,1,31,555,I,630,0,10,Aimer toulouse,A remplir,21
1743,28,1074,561,7,554,513,MN,2014,V,1,31,555,I,561,0,10,Toulouse vert demain europe ecologie les verts parti pirate midi-pyrenees,A remplir,64
1744,41,975,548,11,537,427,MN,2014,V,1,31,555,I,548,0,10,Toulouse vert demain europe ecologie les verts parti pirate midi-pyrenees,A remplir,67
1745,72,1046,510,5,505,536,MN,2014,V,1,31,555,I,510,0,10,Toulouse vert demain europe ecologie les verts parti pirate midi-pyrenees,A remplir,38
1746,105,961,472,16,456,489,MN,2014,V,1,31,555,I,472,0,10,Toulouse vert demain europe ecologie les verts parti pirate midi-pyrenees,A remplir,23
1747,109,1098,619,15,604,479,MN,2014,V,1,31,555,I,619,0,10,Toulouse vert demain europe ecologie les verts parti pirate midi-pyrenees,A remplir,44
1748,117,1119,551,9,542,568,MN,2014,V,1,31,555,I,551,0,10,Toulouse vert demain europe ecologie les verts parti pirate midi-pyrenees,A remplir,31
1749,121,1065,621,6,615,444,MN,2014,V,1,31,555,I,621,0,10,Toulouse vert demain europe ecologie les verts parti pirate midi-pyrenees,A remplir,54
1750,171,1072,450,13,437,622,MN,2014,V,1,31,555,I,450,0,10,Toulouse vert demain europe ecologie les verts parti pirate midi-pyrenees,A remplir,12
1751,174A,1093,484,9,475,609,MN,2014,V,1,31,555,I,484,0,10,Toulouse vert demain europe ecologie les verts parti pirate midi-pyrenees,A remplir,16
1752,192,698,315,9,306,383,MN,2014,V,1,31,555,I,315,0,10,Toulouse vert demain europe ecologie les verts parti pirate midi-pyrenees,A remplir,18
1753,194,863,405,15,390,458,MN,2014,V,1,31,555,I,405,0,10,Toulouse vert demain europe ecologie les verts parti pirate midi-pyrenees,A remplir,33
1754,214,1312,659,16,643,653,MN,2014,V,1,31,555,I,659,0,10,Toulouse vert demain europe ecologie les verts parti pirate midi-pyrenees,A remplir,33
1755,3,919,501,10,491,418,MN,2014,V,1,31,555,I,501,0,10,Toulouse vert demain europe ecologie les verts parti pirate midi-pyrenees,A remplir,29
1756,44A,1061,529,19,510,532,MN,2014,V,1,31,555,I,529,0,10,Toulouse vert demain europe ecologie les verts parti pirate midi-pyrenees,A remplir,48
1757,47,1034,588,11,577,446,MN,2014,V,1,31,555,I,588,0,10,Toulouse vert demain europe ecologie les verts parti pirate midi-pyrenees,A remplir,51
1758,62,1049,498,12,486,551,MN,2014,V,1,31,555,I,498,0,10,Toulouse vert demain europe ecologie les verts parti pirate midi-pyrenees,A remplir,39
1759,82,976,490,12,478,486,MN,2014,V,1,31,555,I,490,0,10,Toulouse vert demain europe ecologie les verts parti pirate midi-pyrenees,A remplir,50
1760,86,1070,542,8,534,528,MN,2014,V,1,31,555,I,542,0,10,Toulouse vert demain europe ecologie les verts parti pirate midi-pyrenees,A remplir,53
1761,127,908,537,9,528,371,MN,2014,V,1,31,555,I,537,0,10,Toulouse vert demain europe ecologie les verts parti pirate midi-pyrenees,A remplir,26
1762,156,889,425,11,414,464,MN,2014,V,1,31,555,I,425,0,10,Toulouse vert demain europe ecologie les verts parti pirate midi-pyrenees,A remplir,27
1763,159,1232,667,12,655,565,MN,2014,V,1,31,555,I,667,0,10,Toulouse vert demain europe ecologie les verts parti pirate midi-pyrenees,A remplir,56
1764,169,953,362,11,351,591,MN,2014,V,1,31,555,I,362,0,10,Toulouse vert demain europe ecologie les verts parti pirate midi-pyrenees,A remplir,9
1765,173,962,388,8,380,574,MN,2014,V,1,31,555,I,388,0,10,Toulouse vert demain europe ecologie les verts parti pirate midi-pyrenees,A remplir,14
1766,203,848,421,16,405,427,MN,2014,V,1,31,555,I,421,0,10,Toulouse vert demain europe ecologie les verts parti pirate midi-pyrenees,A remplir,27
1767,203B,1049,585,16,569,464,MN,2014,V,1,31,555,I,585,0,10,Toulouse vert demain europe ecologie les verts parti pirate midi-pyrenees,A remplir,33
1768,18,1208,703,23,680,505,MN,2014,V,1,31,555,I,703,0,10,Toulouse vert demain europe ecologie les verts parti pirate midi-pyrenees,A remplir,53
1769,48,1004,509,11,498,495,MN,2014,V,1,31,555,I,509,0,10,Toulouse vert demain europe ecologie les verts parti pirate midi-pyrenees,A remplir,30
1770,57,882,517,18,499,365,MN,2014,V,1,31,555,I,517,0,10,Toulouse vert demain europe ecologie les verts parti pirate midi-pyrenees,A remplir,39
1771,68,1002,582,23,559,420,MN,2014,V,1,31,555,I,582,0,10,Toulouse vert demain europe ecologie les verts parti pirate midi-pyrenees,A remplir,31
1772,128,1114,576,22,554,538,MN,2014,V,1,31,555,I,576,0,10,Toulouse vert demain europe ecologie les verts parti pirate midi-pyrenees,A remplir,36
1773,137,995,617,10,607,378,MN,2014,V,1,31,555,I,617,0,10,Toulouse vert demain europe ecologie les verts parti pirate midi-pyrenees,A remplir,43
1774,144A,992,563,13,551,429,MN,2014,V,1,31,555,I,563,0,10,Toulouse vert demain europe ecologie les verts parti pirate midi-pyrenees,A remplir,44
1775,157,1208,645,11,634,563,MN,2014,V,1,31,555,I,645,0,10,Toulouse vert demain europe ecologie les verts parti pirate midi-pyrenees,A remplir,50
1776,166,1147,666,12,653,481,MN,2014,V,1,31,555,I,666,0,10,Toulouse vert demain europe ecologie les verts parti pirate midi-pyrenees,A remplir,61
1777,195,811,443,7,436,368,MN,2014,V,1,31,555,I,443,0,10,Toulouse vert demain europe ecologie les verts parti pirate midi-pyrenees,A remplir,33
1778,200A,1064,537,13,524,527,MN,2014,V,1,31,555,I,537,0,10,Toulouse vert demain europe ecologie les verts parti pirate midi-pyrenees,A remplir,29
1779,203A,817,451,6,445,366,MN,2014,V,1,31,555,I,451,0,10,Toulouse vert demain europe ecologie les verts parti pirate midi-pyrenees,A remplir,16
1780,35,1057,526,10,516,531,MN,2014,V,1,31,555,I,526,0,10,Toulouse vert demain europe ecologie les verts parti pirate midi-pyrenees,A remplir,65
1781,45,1038,429,8,421,609,MN,2014,V,1,31,555,I,429,0,10,Toulouse vert demain europe ecologie les verts parti pirate midi-pyrenees,A remplir,30
1782,61,859,467,16,451,392,MN,2014,V,1,31,555,I,467,0,10,Toulouse vert demain europe ecologie les verts parti pirate midi-pyrenees,A remplir,25
1783,94,1110,641,11,630,469,MN,2014,V,1,31,555,I,641,0,10,Toulouse vert demain europe ecologie les verts parti pirate midi-pyrenees,A remplir,66
1784,107,1019,581,8,573,438,MN,2014,V,1,31,555,I,581,0,10,Toulouse vert demain europe ecologie les verts parti pirate midi-pyrenees,A remplir,26
1785,110,918,502,13,489,416,MN,2014,V,1,31,555,I,502,0,10,Toulouse vert demain europe ecologie les verts parti pirate midi-pyrenees,A remplir,30
1786,134A,1406,745,22,723,661,MN,2014,V,1,31,555,I,745,0,10,Toulouse vert demain europe ecologie les verts parti pirate midi-pyrenees,A remplir,43
1787,146,833,440,3,437,393,MN,2014,V,1,31,555,I,440,0,10,Toulouse vert demain europe ecologie les verts parti pirate midi-pyrenees,A remplir,30
1788,186,1299,322,18,304,977,MN,2014,V,1,31,555,I,322,0,10,Toulouse vert demain europe ecologie les verts parti pirate midi-pyrenees,A remplir,5
1789,195A,1090,474,13,461,616,MN,2014,V,1,31,555,I,474,0,10,Toulouse vert demain europe ecologie les verts parti pirate midi-pyrenees,A remplir,28
1790,16,947,558,10,548,389,MN,2014,V,1,31,555,I,558,0,10,Toulouse vert demain europe ecologie les verts parti pirate midi-pyrenees,A remplir,34
1791,39A,938,525,28,497,413,MN,2014,V,1,31,555,I,525,0,10,Toulouse vert demain europe ecologie les verts parti pirate midi-pyrenees,A remplir,55
1792,85,994,452,13,439,542,MN,2014,V,1,31,555,I,452,0,10,Toulouse vert demain europe ecologie les verts parti pirate midi-pyrenees,A remplir,41
1793,87,1204,619,8,612,585,MN,2014,V,1,31,555,I,619,0,10,Toulouse vert demain europe ecologie les verts parti pirate midi-pyrenees,A remplir,43
1794,93B,1235,656,16,640,579,MN,2014,V,1,31,555,I,656,0,10,Toulouse vert demain europe ecologie les verts parti pirate midi-pyrenees,A remplir,42
1795,101,1126,627,10,617,499,MN,2014,V,1,31,555,I,627,0,10,Toulouse vert demain europe ecologie les verts parti pirate midi-pyrenees,A remplir,62
1796,104,1042,609,21,588,433,MN,2014,V,1,31,555,I,609,0,10,Toulouse vert demain europe ecologie les verts parti pirate midi-pyrenees,A remplir,44
1797,112,841,429,10,419,412,MN,2014,V,1,31,555,I,429,0,10,Toulouse vert demain europe ecologie les verts parti pirate midi-pyrenees,A remplir,18
1798,148,830,418,14,404,412,MN,2014,V,1,31,555,I,418,0,10,Toulouse vert demain europe ecologie les verts parti pirate midi-pyrenees,A remplir,38
1799,207,1141,602,18,584,539,MN,2014,V,1,31,555,I,602,0,10,Toulouse vert demain europe ecologie les verts parti pirate midi-pyrenees,A remplir,54
1800,210,1252,597,16,581,655,MN,2014,V,1,31,555,I,597,0,10,Toulouse vert demain europe ecologie les verts parti pirate midi-pyrenees,A remplir,19
1801,10,979,521,13,508,458,MN,2014,V,1,31,555,I,521,0,10,Toulouse vert demain europe ecologie les verts parti pirate midi-pyrenees,A remplir,39
1802,77,976,544,9,535,432,MN,2014,V,1,31,555,I,544,0,10,Toulouse vert demain europe ecologie les verts parti pirate midi-pyrenees,A remplir,40
1803,91,1000,523,15,508,477,MN,2014,V,1,31,555,I,523,0,10,Toulouse vert demain europe ecologie les verts parti pirate midi-pyrenees,A remplir,43
1804,132,1073,553,5,548,520,MN,2014,V,1,31,555,I,553,0,10,Toulouse vert demain europe ecologie les verts parti pirate midi-pyrenees,A remplir,27
1805,189,832,311,8,303,521,MN,2014,V,1,31,555,I,311,0,10,Toulouse vert demain europe ecologie les verts parti pirate midi-pyrenees,A remplir,12
1806,193A,795,360,9,351,435,MN,2014,V,1,31,555,I,360,0,10,Toulouse vert demain europe ecologie les verts parti pirate midi-pyrenees,A remplir,17
1807,209,1102,507,22,485,595,MN,2014,V,1,31,555,I,507,0,10,Toulouse vert demain europe ecologie les verts parti pirate midi-pyrenees,A remplir,22
1808,212,442,187,4,183,255,MN,2014,V,1,31,555,I,187,0,10,Toulouse vert demain europe ecologie les verts parti pirate midi-pyrenees,A remplir,5
1809,4,956,571,10,561,385,MN,2014,V,1,31,555,I,571,0,10,Toulouse vert demain europe ecologie les verts parti pirate midi-pyrenees,A remplir,22
1810,19,1084,637,8,631,447,MN,2014,V,1,31,555,I,637,0,10,Toulouse vert demain europe ecologie les verts parti pirate midi-pyrenees,A remplir,32
1811,30,992,554,7,547,438,MN,2014,V,1,31,555,I,554,0,10,Toulouse vert demain europe ecologie les verts parti pirate midi-pyrenees,A remplir,37
1812,56,1025,487,8,479,538,MN,2014,V,1,31,555,I,487,0,10,Toulouse vert demain europe ecologie les verts parti pirate midi-pyrenees,A remplir,45
1813,84,1173,642,7,635,531,MN,2014,V,1,31,555,I,642,0,10,Toulouse vert demain europe ecologie les verts parti pirate midi-pyrenees,A remplir,61
1814,93A,1276,661,14,647,615,MN,2014,V,1,31,555,I,661,0,10,Toulouse vert demain europe ecologie les verts parti pirate midi-pyrenees,A remplir,52
1815,144,991,611,13,598,380,MN,2014,V,1,31,555,I,611,0,10,Toulouse vert demain europe ecologie les verts parti pirate midi-pyrenees,A remplir,31
1816,22,1086,605,16,589,481,MN,2014,V,1,31,555,I,605,0,10,Toulouse vert demain europe ecologie les verts parti pirate midi-pyrenees,A remplir,44
1817,25,1083,547,7,540,536,MN,2014,V,1,31,555,I,547,0,10,Toulouse vert demain europe ecologie les verts parti pirate midi-pyrenees,A remplir,58
1818,73,1069,531,13,518,538,MN,2014,V,1,31,555,I,531,0,10,Toulouse vert demain europe ecologie les verts parti pirate midi-pyrenees,A remplir,53
1819,99,933,486,11,475,447,MN,2014,V,1,31,555,I,486,0,10,Toulouse vert demain europe ecologie les verts parti pirate midi-pyrenees,A remplir,26
1820,103,871,459,18,441,412,MN,2014,V,1,31,555,I,459,0,10,Toulouse vert demain europe ecologie les verts parti pirate midi-pyrenees,A remplir,37
1821,140,935,559,9,550,376,MN,2014,V,1,31,555,I,559,0,10,Toulouse vert demain europe ecologie les verts parti pirate midi-pyrenees,A remplir,35
1822,150,1022,574,6,568,448,MN,2014,V,1,31,555,I,574,0,10,Toulouse vert demain europe ecologie les verts parti pirate midi-pyrenees,A remplir,47
1823,168,934,464,17,447,470,MN,2014,V,1,31,555,I,464,0,10,Toulouse vert demain europe ecologie les verts parti pirate midi-pyrenees,A remplir,23
1824,22A,1047,587,16,571,460,MN,2014,V,1,31,555,I,587,0,10,Toulouse vert demain europe ecologie les verts parti pirate midi-pyrenees,A remplir,50
1825,52,1066,539,12,527,527,MN,2014,V,1,31,555,I,539,0,10,Toulouse vert demain europe ecologie les verts parti pirate midi-pyrenees,A remplir,34
1826,66,862,474,16,458,388,MN,2014,V,1,31,555,I,474,0,10,Toulouse vert demain europe ecologie les verts parti pirate midi-pyrenees,A remplir,32
1827,96,978,542,17,525,436,MN,2014,V,1,31,555,I,542,0,10,Toulouse vert demain europe ecologie les verts parti pirate midi-pyrenees,A remplir,45
1828,118,1142,631,12,619,511,MN,2014,V,1,31,555,I,631,0,10,Toulouse vert demain europe ecologie les verts parti pirate midi-pyrenees,A remplir,45
1829,139,965,529,11,518,436,MN,2014,V,1,31,555,I,529,0,10,Toulouse vert demain europe ecologie les verts parti pirate midi-pyrenees,A remplir,32
1830,141,957,569,8,561,388,MN,2014,V,1,31,555,I,569,0,10,Toulouse vert demain europe ecologie les verts parti pirate midi-pyrenees,A remplir,35
1831,164,1183,491,16,475,692,MN,2014,V,1,31,555,I,491,0,10,Toulouse vert demain europe ecologie les verts parti pirate midi-pyrenees,A remplir,33
1832,181,931,370,12,358,561,MN,2014,V,1,31,555,I,370,0,10,Toulouse vert demain europe ecologie les verts parti pirate midi-pyrenees,A remplir,14
1833,211A,1286,623,28,595,663,MN,2014,V,1,31,555,I,623,0,10,Toulouse vert demain europe ecologie les verts parti pirate midi-pyrenees,A remplir,34
1834,2,931,505,12,493,426,MN,2014,V,1,31,555,I,505,0,10,Toulouse vert demain europe ecologie les verts parti pirate midi-pyrenees,A remplir,41
1835,9,941,528,3,525,413,MN,2014,V,1,31,555,I,528,0,10,Toulouse vert demain europe ecologie les verts parti pirate midi-pyrenees,A remplir,38
1836,40,1276,595,11,584,681,MN,2014,V,1,31,555,I,595,0,10,Toulouse vert demain europe ecologie les verts parti pirate midi-pyrenees,A remplir,37
1837,59,1038,581,10,571,457,MN,2014,V,1,31,555,I,581,0,10,Toulouse vert demain europe ecologie les verts parti pirate midi-pyrenees,A remplir,52
1838,88,1122,596,12,584,526,MN,2014,V,1,31,555,I,596,0,10,Toulouse vert demain europe ecologie les verts parti pirate midi-pyrenees,A remplir,44
1839,106,962,481,17,465,481,MN,2014,V,1,31,555,I,481,0,10,Toulouse vert demain europe ecologie les verts parti pirate midi-pyrenees,A remplir,13
1840,120,1058,610,18,592,448,MN,2014,V,1,31,555,I,610,0,10,Toulouse vert demain europe ecologie les verts parti pirate midi-pyrenees,A remplir,30
1841,145,1015,549,14,535,466,MN,2014,V,1,31,555,I,549,0,10,Toulouse vert demain europe ecologie les verts parti pirate midi-pyrenees,A remplir,32
1842,149,1123,622,12,610,501,MN,2014,V,1,31,555,I,622,0,10,Toulouse vert demain europe ecologie les verts parti pirate midi-pyrenees,A remplir,55
1843,201B,1032,580,19,561,452,MN,2014,V,1,31,555,I,580,0,10,Toulouse vert demain europe ecologie les verts parti pirate midi-pyrenees,A remplir,32
1844,206,1087,549,20,529,538,MN,2014,V,1,31,555,I,549,0,10,Toulouse vert demain europe ecologie les verts parti pirate midi-pyrenees,A remplir,33
1845,55,1082,614,14,600,468,MN,2014,V,1,31,555,I,614,0,10,Toulouse vert demain europe ecologie les verts parti pirate midi-pyrenees,A remplir,57
1846,83,1176,712,10,702,464,MN,2014,V,1,31,555,I,712,0,10,Toulouse vert demain europe ecologie les verts parti pirate midi-pyrenees,A remplir,46
1847,136,730,449,8,442,281,MN,2014,V,1,31,555,I,449,0,10,Toulouse vert demain europe ecologie les verts parti pirate midi-pyrenees,A remplir,24
1848,158,1155,634,10,624,521,MN,2014,V,1,31,555,I,634,0,10,Toulouse vert demain europe ecologie les verts parti pirate midi-pyrenees,A remplir,42
1849,162,1033,534,12,522,499,MN,2014,V,1,31,555,I,534,0,10,Toulouse vert demain europe ecologie les verts parti pirate midi-pyrenees,A remplir,36
1850,170,819,446,8,438,373,MN,2014,V,1,31,555,I,446,0,10,Toulouse vert demain europe ecologie les verts parti pirate midi-pyrenees,A remplir,17
1851,172,870,533,11,522,337,MN,2014,V,1,31,555,I,533,0,10,Toulouse vert demain europe ecologie les verts parti pirate midi-pyrenees,A remplir,31
1852,222,1321,665,21,644,656,MN,2014,V,1,31,555,I,665,0,10,Toulouse vert demain europe ecologie les verts parti pirate midi-pyrenees,A remplir,36
1853,7,928,450,9,441,478,MN,2014,V,1,31,555,I,450,0,10,Toulouse vert demain europe ecologie les verts parti pirate midi-pyrenees,A remplir,55
1854,11,1115,633,14,620,482,MN,2014,V,1,31,555,I,633,0,10,Toulouse vert demain europe ecologie les verts parti pirate midi-pyrenees,A remplir,49
1855,21,944,561,12,549,383,MN,2014,V,1,31,555,I,561,0,10,Toulouse vert demain europe ecologie les verts parti pirate midi-pyrenees,A remplir,33
1856,53,1067,569,13,556,498,MN,2014,V,1,31,555,I,569,0,10,Toulouse vert demain europe ecologie les verts parti pirate midi-pyrenees,A remplir,43
1857,122,1038,637,5,632,401,MN,2014,V,1,31,555,I,637,0,10,Toulouse vert demain europe ecologie les verts parti pirate midi-pyrenees,A remplir,26
1858,124,1082,650,16,634,432,MN,2014,V,1,31,555,I,650,0,10,Toulouse vert demain europe ecologie les verts parti pirate midi-pyrenees,A remplir,30
1859,129,990,483,16,467,507,MN,2014,V,1,31,555,I,483,0,10,Toulouse vert demain europe ecologie les verts parti pirate midi-pyrenees,A remplir,24
1860,134,875,516,10,506,359,MN,2014,V,1,31,555,I,516,0,10,Toulouse vert demain europe ecologie les verts parti pirate midi-pyrenees,A remplir,18
1861,135,1027,636,7,630,391,MN,2014,V,1,31,555,I,636,0,10,Toulouse vert demain europe ecologie les verts parti pirate midi-pyrenees,A remplir,36
1862,175,995,320,11,309,675,MN,2014,V,1,31,555,I,320,0,10,Toulouse vert demain europe ecologie les verts parti pirate midi-pyrenees,A remplir,10
1863,177,1084,439,24,415,645,MN,2014,V,1,31,555,I,439,0,10,Toulouse vert demain europe ecologie les verts parti pirate midi-pyrenees,A remplir,24
1864,193,650,268,4,264,382,MN,2014,V,1,31,555,I,268,0,10,Toulouse vert demain europe ecologie les verts parti pirate midi-pyrenees,A remplir,10
1865,199,503,252,4,248,251,MN,2014,V,1,31,555,I,252,0,10,Toulouse vert demain europe ecologie les verts parti pirate midi-pyrenees,A remplir,4
1866,213,1101,583,17,566,518,MN,2014,V,1,31,555,I,583,0,10,Toulouse vert demain europe ecologie les verts parti pirate midi-pyrenees,A remplir,37
1867,219,1138,614,10,604,524,MN,2014,V,1,31,555,I,614,0,10,Toulouse vert demain europe ecologie les verts parti pirate midi-pyrenees,A remplir,35
1868,12,1116,608,12,596,508,MN,2014,V,1,31,555,I,608,0,10,Toulouse vert demain europe ecologie les verts parti pirate midi-pyrenees,A remplir,33
1869,31,1020,561,8,553,459,MN,2014,V,1,31,555,I,561,0,10,Toulouse vert demain europe ecologie les verts parti pirate midi-pyrenees,A remplir,23
1870,36,806,435,14,421,371,MN,2014,V,1,31,555,I,435,0,10,Toulouse vert demain europe ecologie les verts parti pirate midi-pyrenees,A remplir,26
1871,46,986,558,11,547,428,MN,2014,V,1,31,555,I,558,0,10,Toulouse vert demain europe ecologie les verts parti pirate midi-pyrenees,A remplir,23
1872,81,1177,499,16,483,678,MN,2014,V,1,31,555,I,499,0,10,Toulouse vert demain europe ecologie les verts parti pirate midi-pyrenees,A remplir,41
1873,142,890,459,6,453,431,MN,2014,V,1,31,555,I,459,0,10,Toulouse vert demain europe ecologie les verts parti pirate midi-pyrenees,A remplir,9
1874,152,944,355,14,341,589,MN,2014,V,1,31,555,I,355,0,10,Toulouse vert demain europe ecologie les verts parti pirate midi-pyrenees,A remplir,20
1875,167,995,543,9,534,452,MN,2014,V,1,31,555,I,543,0,10,Toulouse vert demain europe ecologie les verts parti pirate midi-pyrenees,A remplir,41
1876,190,1008,247,9,238,761,MN,2014,V,1,31,555,I,247,0,10,Toulouse vert demain europe ecologie les verts parti pirate midi-pyrenees,A remplir,5
1877,225,838,451,16,435,387,MN,2014,V,1,31,555,I,451,0,10,Toulouse vert demain europe ecologie les verts parti pirate midi-pyrenees,A remplir,27
1878,49,759,440,8,432,319,MN,2014,V,1,31,555,I,440,0,10,Toulouse vert demain europe ecologie les verts parti pirate midi-pyrenees,A remplir,34
1879,50,977,533,16,517,444,MN,2014,V,1,31,555,I,533,0,10,Toulouse vert demain europe ecologie les verts parti pirate midi-pyrenees,A remplir,45
1880,60,1164,611,25,586,553,MN,2014,V,1,31,555,I,611,0,10,Toulouse vert demain europe ecologie les verts parti pirate midi-pyrenees,A remplir,56
1881,108A,939,523,13,510,416,MN,2014,V,1,31,555,I,523,0,10,Toulouse vert demain europe ecologie les verts parti pirate midi-pyrenees,A remplir,32
1882,125,957,575,11,564,382,MN,2014,V,1,31,555,I,575,0,10,Toulouse vert demain europe ecologie les verts parti pirate midi-pyrenees,A remplir,42
1883,182,794,435,10,425,359,MN,2014,V,1,31,555,I,435,0,10,Toulouse vert demain europe ecologie les verts parti pirate midi-pyrenees,A remplir,29
1884,215,1373,629,18,611,744,MN,2014,V,1,31,555,I,629,0,10,Toulouse vert demain europe ecologie les verts parti pirate midi-pyrenees,A remplir,49
1885,1,1100,541,10,532,559,MN,2014,V,1,31,555,I,541,0,10,Toulouse vert demain europe ecologie les verts parti pirate midi-pyrenees,A remplir,45
1886,44,971,558,16,542,413,MN,2014,V,1,31,555,I,558,0,10,Toulouse vert demain europe ecologie les verts parti pirate midi-pyrenees,A remplir,48
1887,49A,856,513,8,505,343,MN,2014,V,1,31,555,I,513,0,10,Toulouse vert demain europe ecologie les verts parti pirate midi-pyrenees,A remplir,30
1888,165A,982,609,11,598,373,MN,2014,V,1,31,555,I,609,0,10,Toulouse vert demain europe ecologie les verts parti pirate midi-pyrenees,A remplir,36
1889,200,1192,654,15,639,538,MN,2014,V,1,31,555,I,654,0,10,Toulouse vert demain europe ecologie les verts parti pirate midi-pyrenees,A remplir,31
1890,5,772,439,10,429,333,MN,2014,V,1,31,555,I,439,0,10,Toulouse vert demain europe ecologie les verts parti pirate midi-pyrenees,A remplir,12
1891,24,1061,543,8,535,518,MN,2014,V,1,31,555,I,543,0,10,Toulouse vert demain europe ecologie les verts parti pirate midi-pyrenees,A remplir,65
1892,25A,1002,518,11,507,484,MN,2014,V,1,31,555,I,518,0,10,Toulouse vert demain europe ecologie les verts parti pirate midi-pyrenees,A remplir,43
1893,51,1230,659,18,641,571,MN,2014,V,1,31,555,I,659,0,10,Toulouse vert demain europe ecologie les verts parti pirate midi-pyrenees,A remplir,46
1894,71,941,513,10,504,428,MN,2014,V,1,31,555,I,513,0,10,Toulouse vert demain europe ecologie les verts parti pirate midi-pyrenees,A remplir,50
1895,78,1006,624,19,605,382,MN,2014,V,1,31,555,I,624,0,10,Toulouse vert demain europe ecologie les verts parti pirate midi-pyrenees,A remplir,43
1896,79,915,498,6,491,417,MN,2014,V,1,31,555,I,498,0,10,Toulouse vert demain europe ecologie les verts parti pirate midi-pyrenees,A remplir,52
1897,80,1173,553,9,544,620,MN,2014,V,1,31,555,I,553,0,10,Toulouse vert demain europe ecologie les verts parti pirate midi-pyrenees,A remplir,53
1898,97,1084,564,10,553,520,MN,2014,V,1,31,555,I,564,0,10,Toulouse vert demain europe ecologie les verts parti pirate midi-pyrenees,A remplir,35
1899,184,1151,355,10,345,796,MN,2014,V,1,31,555,I,355,0,10,Toulouse vert demain europe ecologie les verts parti pirate midi-pyrenees,A remplir,7
1900,188,1220,497,20,477,723,MN,2014,V,1,31,555,I,497,0,10,Toulouse vert demain europe ecologie les verts parti pirate midi-pyrenees,A remplir,14
1901,8,891,480,13,467,411,MN,2014,V,1,31,555,I,480,0,10,Toulouse vert demain europe ecologie les verts parti pirate midi-pyrenees,A remplir,43
1902,14,1014,595,6,589,419,MN,2014,V,1,31,555,I,595,0,10,Toulouse vert demain europe ecologie les verts parti pirate midi-pyrenees,A remplir,50
1903,34,953,496,10,486,457,MN,2014,V,1,31,555,I,496,0,10,Toulouse vert demain europe ecologie les verts parti pirate midi-pyrenees,A remplir,44
1904,39,1160,603,12,591,557,MN,2014,V,1,31,555,I,603,0,10,Toulouse vert demain europe ecologie les verts parti pirate midi-pyrenees,A remplir,52
1905,63,806,314,6,308,492,MN,2014,V,1,31,555,I,314,0,10,Toulouse vert demain europe ecologie les verts parti pirate midi-pyrenees,A remplir,21
1906,124A,982,582,15,567,400,MN,2014,V,1,31,555,I,582,0,10,Toulouse vert demain europe ecologie les verts parti pirate midi-pyrenees,A remplir,32
1907,205,1184,651,18,633,533,MN,2014,V,1,31,555,I,651,0,10,Toulouse vert demain europe ecologie les verts parti pirate midi-pyrenees,A remplir,37
1908,6,1098,531,11,520,567,MN,2014,V,1,31,555,I,531,0,10,Toulouse vert demain europe ecologie les verts parti pirate midi-pyrenees,A remplir,53
1909,23,1205,614,7,607,591,MN,2014,V,1,31,555,I,614,0,10,Toulouse vert demain europe ecologie les verts parti pirate midi-pyrenees,A remplir,61
1910,64,1233,675,22,653,558,MN,2014,V,1,31,555,I,675,0,10,Toulouse vert demain europe ecologie les verts parti pirate midi-pyrenees,A remplir,51
1911,75,949,456,15,441,493,MN,2014,V,1,31,555,I,456,0,10,Toulouse vert demain europe ecologie les verts parti pirate midi-pyrenees,A remplir,49
1912,76,1007,517,7,510,490,MN,2014,V,1,31,555,I,517,0,10,Toulouse vert demain europe ecologie les verts parti pirate midi-pyrenees,A remplir,43
1913,111,956,511,10,501,445,MN,2014,V,1,31,555,I,511,0,10,Toulouse vert demain europe ecologie les verts parti pirate midi-pyrenees,A remplir,47
1914,123,1134,589,8,581,545,MN,2014,V,1,31,555,I,589,0,10,Toulouse vert demain europe ecologie les verts parti pirate midi-pyrenees,A remplir,53
1915,131,1051,602,12,590,449,MN,2014,V,1,31,555,I,602,0,10,Toulouse vert demain europe ecologie les verts parti pirate midi-pyrenees,A remplir,31
1916,154,809,278,13,265,531,MN,2014,V,1,31,555,I,278,0,10,Toulouse vert demain europe ecologie les verts parti pirate midi-pyrenees,A remplir,14
1917,179,709,357,9,348,352,MN,2014,V,1,31,555,I,357,0,10,Toulouse vert demain europe ecologie les verts parti pirate midi-pyrenees,A remplir,13
1918,211,1377,732,18,714,645,MN,2014,V,1,31,555,I,732,0,10,Toulouse vert demain europe ecologie les verts parti pirate midi-pyrenees,A remplir,41
1919,13,1041,588,11,577,453,MN,2014,V,1,31,555,I,588,0,10,Toulouse vert demain europe ecologie les verts parti pirate midi-pyrenees,A remplir,72
1920,15,1078,643,10,633,435,MN,2014,V,1,31,555,I,643,0,10,Toulouse vert demain europe ecologie les verts parti pirate midi-pyrenees,A remplir,48
1921,27,1122,647,10,637,475,MN,2014,V,1,31,555,I,647,0,10,Toulouse vert demain europe ecologie les verts parti pirate midi-pyrenees,A remplir,44
1922,36A,1124,605,14,591,519,MN,2014,V,1,31,555,I,605,0,10,Toulouse vert demain europe ecologie les verts parti pirate midi-pyrenees,A remplir,85
1923,56A,894,469,9,460,425,MN,2014,V,1,31,555,I,469,0,10,Toulouse vert demain europe ecologie les verts parti pirate midi-pyrenees,A remplir,32
1924,69,1090,574,12,562,516,MN,2014,V,1,31,555,I,574,0,10,Toulouse vert demain europe ecologie les verts parti pirate midi-pyrenees,A remplir,34
1925,113,1030,455,18,437,575,MN,2014,V,1,31,555,I,455,0,10,Toulouse vert demain europe ecologie les verts parti pirate midi-pyrenees,A remplir,28
1926,147,1006,591,11,580,415,MN,2014,V,1,31,555,I,591,0,10,Toulouse vert demain europe ecologie les verts parti pirate midi-pyrenees,A remplir,48
1927,165,1463,797,24,773,666,MN,2014,V,1,31,555,I,797,0,10,Toulouse vert demain europe ecologie les verts parti pirate midi-pyrenees,A remplir,63
1928,201A,1154,711,21,690,443,MN,2014,V,1,31,555,I,711,0,10,Toulouse vert demain europe ecologie les verts parti pirate midi-pyrenees,A remplir,35
1929,204,1153,587,18,569,566,MN,2014,V,1,31,555,I,587,0,10,Toulouse vert demain europe ecologie les verts parti pirate midi-pyrenees,A remplir,23
1930,218,1264,701,15,686,563,MN,2014,V,1,31,555,I,701,0,10,Toulouse vert demain europe ecologie les verts parti pirate midi-pyrenees,A remplir,41
1931,220,1242,685,19,666,557,MN,2014,V,1,31,555,I,685,0,10,Toulouse vert demain europe ecologie les verts parti pirate midi-pyrenees,A remplir,42
1932,42,962,516,14,502,446,MN,2014,V,1,31,555,I,516,0,10,Toulouse vert demain europe ecologie les verts parti pirate midi-pyrenees,A remplir,42
1933,58,1199,536,13,523,663,MN,2014,V,1,31,555,I,536,0,10,Toulouse vert demain europe ecologie les verts parti pirate midi-pyrenees,A remplir,39
1934,95,1039,530,11,519,509,MN,2014,V,1,31,555,I,530,0,10,Toulouse vert demain europe ecologie les verts parti pirate midi-pyrenees,A remplir,43
1935,116,1060,541,13,528,519,MN,2014,V,1,31,555,I,541,0,10,Toulouse vert demain europe ecologie les verts parti pirate midi-pyrenees,A remplir,32
1936,151,983,544,9,535,439,MN,2014,V,1,31,555,I,544,0,10,Toulouse vert demain europe ecologie les verts parti pirate midi-pyrenees,A remplir,53
1937,155,726,257,7,250,469,MN,2014,V,1,31,555,I,257,0,10,Toulouse vert demain europe ecologie les verts parti pirate midi-pyrenees,A remplir,23
1938,198B,1072,625,17,608,447,MN,2014,V,1,31,555,I,625,0,10,Toulouse vert demain europe ecologie les verts parti pirate midi-pyrenees,A remplir,32
1939,201,1015,630,10,620,385,MN,2014,V,1,31,555,I,630,0,10,Toulouse vert demain europe ecologie les verts parti pirate midi-pyrenees,A remplir,27
1940,224,780,412,11,401,368,MN,2014,V,1,31,555,I,412,0,10,Toulouse vert demain europe ecologie les verts parti pirate midi-pyrenees,A remplir,34
1941,17,940,535,10,525,405,MN,2014,V,1,31,555,I,535,0,10,Toulouse vert demain europe ecologie les verts parti pirate midi-pyrenees,A remplir,30
1942,65,1142,646,19,627,496,MN,2014,V,1,31,555,I,646,0,10,Toulouse vert demain europe ecologie les verts parti pirate midi-pyrenees,A remplir,38
1943,67,983,550,21,529,433,MN,2014,V,1,31,555,I,550,0,10,Toulouse vert demain europe ecologie les verts parti pirate midi-pyrenees,A remplir,40
1944,102,739,369,8,361,370,MN,2014,V,1,31,555,I,369,0,10,Toulouse vert demain europe ecologie les verts parti pirate midi-pyrenees,A remplir,33
1945,113A,976,526,13,513,450,MN,2014,V,1,31,555,I,526,0,10,Toulouse vert demain europe ecologie les verts parti pirate midi-pyrenees,A remplir,32
1946,119,970,576,9,567,394,MN,2014,V,1,31,555,I,576,0,10,Toulouse vert demain europe ecologie les verts parti pirate midi-pyrenees,A remplir,34
1947,191A,925,327,20,307,598,MN,2014,V,1,31,555,I,327,0,10,Toulouse vert demain europe ecologie les verts parti pirate midi-pyrenees,A remplir,9
1948,198,1241,700,19,681,541,MN,2014,V,1,31,555,I,700,0,10,Toulouse vert demain europe ecologie les verts parti pirate midi-pyrenees,A remplir,59
1949,208,1196,696,27,669,500,MN,2014,V,1,31,555,I,696,0,10,Toulouse vert demain europe ecologie les verts parti pirate midi-pyrenees,A remplir,48
1950,32,848,516,8,508,332,MN,2014,V,1,31,555,I,516,0,10,Toulouse vert demain europe ecologie les verts parti pirate midi-pyrenees,A remplir,19
1951,33,1059,631,17,614,428,MN,2014,V,1,31,555,I,631,0,10,Toulouse vert demain europe ecologie les verts parti pirate midi-pyrenees,A remplir,67
1952,44B,805,394,16,378,411,MN,2014,V,1,31,555,I,394,0,10,Toulouse vert demain europe ecologie les verts parti pirate midi-pyrenees,A remplir,22
1953,54,991,513,15,497,478,MN,2014,V,1,31,555,I,513,0,10,Toulouse vert demain europe ecologie les verts parti pirate midi-pyrenees,A remplir,43
1954,92,1184,581,19,562,603,MN,2014,V,1,31,555,I,581,0,10,Toulouse vert demain europe ecologie les verts parti pirate midi-pyrenees,A remplir,57
1955,93,1248,671,22,649,577,MN,2014,V,1,31,555,I,671,0,10,Toulouse vert demain europe ecologie les verts parti pirate midi-pyrenees,A remplir,72
1956,108,1029,598,16,582,431,MN,2014,V,1,31,555,I,598,0,10,Toulouse vert demain europe ecologie les verts parti pirate midi-pyrenees,A remplir,29
1957,138,889,558,15,543,331,MN,2014,V,1,31,555,I,558,0,10,Toulouse vert demain europe ecologie les verts parti pirate midi-pyrenees,A remplir,32
1958,153,706,148,5,143,558,MN,2014,V,1,31,555,I,148,0,10,Toulouse vert demain europe ecologie les verts parti pirate midi-pyrenees,A remplir,8
1959,163,1016,466,7,460,550,MN,2014,V,1,31,555,I,466,0,10,Toulouse vert demain europe ecologie les verts parti pirate midi-pyrenees,A remplir,26
1960,191,1000,255,12,243,745,MN,2014,V,1,31,555,I,255,0,10,Toulouse vert demain europe ecologie les verts parti pirate midi-pyrenees,A remplir,5
1961,197,994,590,20,570,404,MN,2014,V,1,31,555,I,590,0,10,Toulouse vert demain europe ecologie les verts parti pirate midi-pyrenees,A remplir,55
1962,198A,955,556,15,541,399,MN,2014,V,1,31,555,I,556,0,10,Toulouse vert demain europe ecologie les verts parti pirate midi-pyrenees,A remplir,31
1963,223,1190,637,21,616,553,MN,2014,V,1,31,555,I,637,0,10,Toulouse vert demain europe ecologie les verts parti pirate midi-pyrenees,A remplir,40
1964,226,987,505,6,499,482,MN,2014,V,1,31,555,I,505,0,10,Toulouse vert demain europe ecologie les verts parti pirate midi-pyrenees,A remplir,28
1965,37,890,465,15,450,425,MN,2014,V,1,31,555,I,465,0,10,Toulouse vert demain europe ecologie les verts parti pirate midi-pyrenees,A remplir,46
1966,70,1004,580,14,566,424,MN,2014,V,1,31,555,I,580,0,10,Toulouse vert demain europe ecologie les verts parti pirate midi-pyrenees,A remplir,42
1967,74,1059,538,7,531,521,MN,2014,V,1,31,555,I,538,0,10,Toulouse vert demain europe ecologie les verts parti pirate midi-pyrenees,A remplir,36
1968,178,970,371,10,361,599,MN,2014,V,1,31,555,I,371,0,10,Toulouse vert demain europe ecologie les verts parti pirate midi-pyrenees,A remplir,16
1969,10A,1006,494,11,483,512,MN,2014,V,1,31,555,I,494,0,10,Toulouse vert demain europe ecologie les verts parti pirate midi-pyrenees,A remplir,39
1970,29,1159,606,9,598,553,MN,2014,V,1,31,555,I,606,0,10,Toulouse vert demain europe ecologie les verts parti pirate midi-pyrenees,A remplir,56
1971,67A,929,482,11,471,447,MN,2014,V,1,31,555,I,482,0,10,Toulouse vert demain europe ecologie les verts parti pirate midi-pyrenees,A remplir,35
1972,100,1027,479,9,470,548,MN,2014,V,1,31,555,I,479,0,10,Toulouse vert demain europe ecologie les verts parti pirate midi-pyrenees,A remplir,71
1973,114,1108,530,15,515,578,MN,2014,V,1,31,555,I,530,0,10,Toulouse vert demain europe ecologie les verts parti pirate midi-pyrenees,A remplir,28
1974,126,911,511,9,502,400,MN,2014,V,1,31,555,I,511,0,10,Toulouse vert demain europe ecologie les verts parti pirate midi-pyrenees,A remplir,28
1975,130,1083,574,13,561,509,MN,2014,V,1,31,555,I,574,0,10,Toulouse vert demain europe ecologie les verts parti pirate midi-pyrenees,A remplir,30
1976,161,967,524,11,513,443,MN,2014,V,1,31,555,I,524,0,10,Toulouse vert demain europe ecologie les verts parti pirate midi-pyrenees,A remplir,35
1977,174,1101,559,8,551,542,MN,2014,V,1,31,555,I,559,0,10,Toulouse vert demain europe ecologie les verts parti pirate midi-pyrenees,A remplir,28
1978,202,1197,556,19,537,641,MN,2014,V,1,31,555,I,556,0,10,Toulouse vert demain europe ecologie les verts parti pirate midi-pyrenees,A remplir,35
1979,216,1186,583,17,566,603,MN,2014,V,1,31,555,I,583,0,10,Toulouse vert demain europe ecologie les verts parti pirate midi-pyrenees,A remplir,32
1980,216A,1122,459,20,439,663,MN,2014,V,1,31,555,I,459,0,10,Toulouse vert demain europe ecologie les verts parti pirate midi-pyrenees,A remplir,20
1981,20,1041,656,16,640,385,MN,2014,V,1,31,555,I,656,0,10,Toulouse vert demain europe ecologie les verts parti pirate midi-pyrenees,A remplir,56
1982,38,975,516,18,498,459,MN,2014,V,1,31,555,I,516,0,10,Toulouse vert demain europe ecologie les verts parti pirate midi-pyrenees,A remplir,46
1983,43,1026,583,21,562,443,MN,2014,V,1,31,555,I,583,0,10,Toulouse vert demain europe ecologie les verts parti pirate midi-pyrenees,A remplir,36
1984,133,983,556,15,541,427,MN,2014,V,1,31,555,I,556,0,10,Toulouse vert demain europe ecologie les verts parti pirate midi-pyrenees,A remplir,21
1985,138A,951,606,17,589,345,MN,2014,V,1,31,555,I,606,0,10,Toulouse vert demain europe ecologie les verts parti pirate midi-pyrenees,A remplir,26
1986,143,984,592,9,583,392,MN,2014,V,1,31,555,I,592,0,10,Toulouse vert demain europe ecologie les verts parti pirate midi-pyrenees,A remplir,34
1987,160,1056,563,10,553,493,MN,2014,V,1,31,555,I,563,0,10,Toulouse vert demain europe ecologie les verts parti pirate midi-pyrenees,A remplir,31
1988,180,755,275,2,273,480,MN,2014,V,1,31,555,I,275,0,10,Toulouse vert demain europe ecologie les verts parti pirate midi-pyrenees,A remplir,7
1989,195B,1078,677,18,659,401,MN,2014,V,1,31,555,I,677,0,10,Toulouse vert demain europe ecologie les verts parti pirate midi-pyrenees,A remplir,50
1990,196,1165,666,15,651,499,MN,2014,V,1,31,555,I,666,0,10,Toulouse vert demain europe ecologie les verts parti pirate midi-pyrenees,A remplir,37
1991,217,1275,630,18,612,645,MN,2014,V,1,31,555,I,630,0,10,Toulouse vert demain europe ecologie les verts parti pirate midi-pyrenees,A remplir,36
1992,28,1074,561,7,554,513,MN,2014,V,1,31,555,I,561,0,10,"Avec vous, toulouse avance !",A remplir,138
1993,41,975,548,11,537,427,MN,2014,V,1,31,555,I,548,0,10,"Avec vous, toulouse avance !",A remplir,179
1994,72,1046,510,5,505,536,MN,2014,V,1,31,555,I,510,0,10,"Avec vous, toulouse avance !",A remplir,176
1995,105,961,472,16,456,489,MN,2014,V,1,31,555,I,472,0,10,"Avec vous, toulouse avance !",A remplir,143
1996,109,1098,619,15,604,479,MN,2014,V,1,31,555,I,619,0,10,"Avec vous, toulouse avance !",A remplir,152
1997,117,1119,551,9,542,568,MN,2014,V,1,31,555,I,551,0,10,"Avec vous, toulouse avance !",A remplir,177
1998,121,1065,621,6,615,444,MN,2014,V,1,31,555,I,621,0,10,"Avec vous, toulouse avance !",A remplir,148
1999,171,1072,450,13,437,622,MN,2014,V,1,31,555,I,450,0,10,"Avec vous, toulouse avance !",A remplir,139
2000,174A,1093,484,9,475,609,MN,2014,V,1,31,555,I,484,0,10,"Avec vous, toulouse avance !",A remplir,123
2001,192,698,315,9,306,383,MN,2014,V,1,31,555,I,315,0,10,"Avec vous, toulouse avance !",A remplir,78
2002,194,863,405,15,390,458,MN,2014,V,1,31,555,I,405,0,10,"Avec vous, toulouse avance !",A remplir,131
2003,214,1312,659,16,643,653,MN,2014,V,1,31,555,I,659,0,10,"Avec vous, toulouse avance !",A remplir,198
2004,3,919,501,10,491,418,MN,2014,V,1,31,555,I,501,0,10,"Avec vous, toulouse avance !",A remplir,129
2005,44A,1061,529,19,510,532,MN,2014,V,1,31,555,I,529,0,10,"Avec vous, toulouse avance !",A remplir,186
2006,47,1034,588,11,577,446,MN,2014,V,1,31,555,I,588,0,10,"Avec vous, toulouse avance !",A remplir,209
2007,62,1049,498,12,486,551,MN,2014,V,1,31,555,I,498,0,10,"Avec vous, toulouse avance !",A remplir,172
2008,82,976,490,12,478,486,MN,2014,V,1,31,555,I,490,0,10,"Avec vous, toulouse avance !",A remplir,136
2009,86,1070,542,8,534,528,MN,2014,V,1,31,555,I,542,0,10,"Avec vous, toulouse avance !",A remplir,209
2010,127,908,537,9,528,371,MN,2014,V,1,31,555,I,537,0,10,"Avec vous, toulouse avance !",A remplir,139
2011,156,889,425,11,414,464,MN,2014,V,1,31,555,I,425,0,10,"Avec vous, toulouse avance !",A remplir,145
2012,159,1232,667,12,655,565,MN,2014,V,1,31,555,I,667,0,10,"Avec vous, toulouse avance !",A remplir,244
2013,169,953,362,11,351,591,MN,2014,V,1,31,555,I,362,0,10,"Avec vous, toulouse avance !",A remplir,113
2014,173,962,388,8,380,574,MN,2014,V,1,31,555,I,388,0,10,"Avec vous, toulouse avance !",A remplir,114
2015,203,848,421,16,405,427,MN,2014,V,1,31,555,I,421,0,10,"Avec vous, toulouse avance !",A remplir,113
2016,203B,1049,585,16,569,464,MN,2014,V,1,31,555,I,585,0,10,"Avec vous, toulouse avance !",A remplir,150
2017,18,1208,703,23,680,505,MN,2014,V,1,31,555,I,703,0,10,"Avec vous, toulouse avance !",A remplir,226
2018,48,1004,509,11,498,495,MN,2014,V,1,31,555,I,509,0,10,"Avec vous, toulouse avance !",A remplir,204
2019,57,882,517,18,499,365,MN,2014,V,1,31,555,I,517,0,10,"Avec vous, toulouse avance !",A remplir,167
2020,68,1002,582,23,559,420,MN,2014,V,1,31,555,I,582,0,10,"Avec vous, toulouse avance !",A remplir,200
2021,128,1114,576,22,554,538,MN,2014,V,1,31,555,I,576,0,10,"Avec vous, toulouse avance !",A remplir,191
2022,137,995,617,10,607,378,MN,2014,V,1,31,555,I,617,0,10,"Avec vous, toulouse avance !",A remplir,176
2023,144A,992,563,13,551,429,MN,2014,V,1,31,555,I,563,0,10,"Avec vous, toulouse avance !",A remplir,163
2024,157,1208,645,11,634,563,MN,2014,V,1,31,555,I,645,0,10,"Avec vous, toulouse avance !",A remplir,227
2025,166,1147,666,12,653,481,MN,2014,V,1,31,555,I,666,0,10,"Avec vous, toulouse avance !",A remplir,236
2026,195,811,443,7,436,368,MN,2014,V,1,31,555,I,443,0,10,"Avec vous, toulouse avance !",A remplir,115
2027,200A,1064,537,13,524,527,MN,2014,V,1,31,555,I,537,0,10,"Avec vous, toulouse avance !",A remplir,109
2028,203A,817,451,6,445,366,MN,2014,V,1,31,555,I,451,0,10,"Avec vous, toulouse avance !",A remplir,106
2029,35,1057,526,10,516,531,MN,2014,V,1,31,555,I,526,0,10,"Avec vous, toulouse avance !",A remplir,223
2030,45,1038,429,8,421,609,MN,2014,V,1,31,555,I,429,0,10,"Avec vous, toulouse avance !",A remplir,143
2031,61,859,467,16,451,392,MN,2014,V,1,31,555,I,467,0,10,"Avec vous, toulouse avance !",A remplir,164
2032,94,1110,641,11,630,469,MN,2014,V,1,31,555,I,641,0,10,"Avec vous, toulouse avance !",A remplir,233
2033,107,1019,581,8,573,438,MN,2014,V,1,31,555,I,581,0,10,"Avec vous, toulouse avance !",A remplir,141
2034,110,918,502,13,489,416,MN,2014,V,1,31,555,I,502,0,10,"Avec vous, toulouse avance !",A remplir,136
2035,134A,1406,745,22,723,661,MN,2014,V,1,31,555,I,745,0,10,"Avec vous, toulouse avance !",A remplir,217
2036,146,833,440,3,437,393,MN,2014,V,1,31,555,I,440,0,10,"Avec vous, toulouse avance !",A remplir,143
2037,186,1299,322,18,304,977,MN,2014,V,1,31,555,I,322,0,10,"Avec vous, toulouse avance !",A remplir,118
2038,195A,1090,474,13,461,616,MN,2014,V,1,31,555,I,474,0,10,"Avec vous, toulouse avance !",A remplir,134
2039,16,947,558,10,548,389,MN,2014,V,1,31,555,I,558,0,10,"Avec vous, toulouse avance !",A remplir,182
2040,39A,938,525,28,497,413,MN,2014,V,1,31,555,I,525,0,10,"Avec vous, toulouse avance !",A remplir,169
2041,85,994,452,13,439,542,MN,2014,V,1,31,555,I,452,0,10,"Avec vous, toulouse avance !",A remplir,152
2042,87,1204,619,8,612,585,MN,2014,V,1,31,555,I,619,0,10,"Avec vous, toulouse avance !",A remplir,205
2043,93B,1235,656,16,640,579,MN,2014,V,1,31,555,I,656,0,10,"Avec vous, toulouse avance !",A remplir,188
2044,101,1126,627,10,617,499,MN,2014,V,1,31,555,I,627,0,10,"Avec vous, toulouse avance !",A remplir,219
2045,104,1042,609,21,588,433,MN,2014,V,1,31,555,I,609,0,10,"Avec vous, toulouse avance !",A remplir,180
2046,112,841,429,10,419,412,MN,2014,V,1,31,555,I,429,0,10,"Avec vous, toulouse avance !",A remplir,142
2047,148,830,418,14,404,412,MN,2014,V,1,31,555,I,418,0,10,"Avec vous, toulouse avance !",A remplir,132
2048,207,1141,602,18,584,539,MN,2014,V,1,31,555,I,602,0,10,"Avec vous, toulouse avance !",A remplir,187
2049,210,1252,597,16,581,655,MN,2014,V,1,31,555,I,597,0,10,"Avec vous, toulouse avance !",A remplir,166
2050,10,979,521,13,508,458,MN,2014,V,1,31,555,I,521,0,10,"Avec vous, toulouse avance !",A remplir,181
2051,77,976,544,9,535,432,MN,2014,V,1,31,555,I,544,0,10,"Avec vous, toulouse avance !",A remplir,188
2052,91,1000,523,15,508,477,MN,2014,V,1,31,555,I,523,0,10,"Avec vous, toulouse avance !",A remplir,184
2053,132,1073,553,5,548,520,MN,2014,V,1,31,555,I,553,0,10,"Avec vous, toulouse avance !",A remplir,150
2054,189,832,311,8,303,521,MN,2014,V,1,31,555,I,311,0,10,"Avec vous, toulouse avance !",A remplir,119
2055,193A,795,360,9,351,435,MN,2014,V,1,31,555,I,360,0,10,"Avec vous, toulouse avance !",A remplir,90
2056,209,1102,507,22,485,595,MN,2014,V,1,31,555,I,507,0,10,"Avec vous, toulouse avance !",A remplir,170
2057,212,442,187,4,183,255,MN,2014,V,1,31,555,I,187,0,10,"Avec vous, toulouse avance !",A remplir,49
2058,4,956,571,10,561,385,MN,2014,V,1,31,555,I,571,0,10,"Avec vous, toulouse avance !",A remplir,110
2059,19,1084,637,8,631,447,MN,2014,V,1,31,555,I,637,0,10,"Avec vous, toulouse avance !",A remplir,174
2060,30,992,554,7,547,438,MN,2014,V,1,31,555,I,554,0,10,"Avec vous, toulouse avance !",A remplir,123
2061,56,1025,487,8,479,538,MN,2014,V,1,31,555,I,487,0,10,"Avec vous, toulouse avance !",A remplir,165
2062,84,1173,642,7,635,531,MN,2014,V,1,31,555,I,642,0,10,"Avec vous, toulouse avance !",A remplir,222
2063,93A,1276,661,14,647,615,MN,2014,V,1,31,555,I,661,0,10,"Avec vous, toulouse avance !",A remplir,235
2064,144,991,611,13,598,380,MN,2014,V,1,31,555,I,611,0,10,"Avec vous, toulouse avance !",A remplir,158
2065,22,1086,605,16,589,481,MN,2014,V,1,31,555,I,605,0,10,"Avec vous, toulouse avance !",A remplir,163
2066,25,1083,547,7,540,536,MN,2014,V,1,31,555,I,547,0,10,"Avec vous, toulouse avance !",A remplir,200
2067,73,1069,531,13,518,538,MN,2014,V,1,31,555,I,531,0,10,"Avec vous, toulouse avance !",A remplir,185
2068,99,933,486,11,475,447,MN,2014,V,1,31,555,I,486,0,10,"Avec vous, toulouse avance !",A remplir,188
2069,103,871,459,18,441,412,MN,2014,V,1,31,555,I,459,0,10,"Avec vous, toulouse avance !",A remplir,152
2070,140,935,559,9,550,376,MN,2014,V,1,31,555,I,559,0,10,"Avec vous, toulouse avance !",A remplir,125
2071,150,1022,574,6,568,448,MN,2014,V,1,31,555,I,574,0,10,"Avec vous, toulouse avance !",A remplir,232
2072,168,934,464,17,447,470,MN,2014,V,1,31,555,I,464,0,10,"Avec vous, toulouse avance !",A remplir,142
2073,22A,1047,587,16,571,460,MN,2014,V,1,31,555,I,587,0,10,"Avec vous, toulouse avance !",A remplir,158
2074,52,1066,539,12,527,527,MN,2014,V,1,31,555,I,539,0,10,"Avec vous, toulouse avance !",A remplir,179
2075,66,862,474,16,458,388,MN,2014,V,1,31,555,I,474,0,10,"Avec vous, toulouse avance !",A remplir,165
2076,96,978,542,17,525,436,MN,2014,V,1,31,555,I,542,0,10,"Avec vous, toulouse avance !",A remplir,167
2077,118,1142,631,12,619,511,MN,2014,V,1,31,555,I,631,0,10,"Avec vous, toulouse avance !",A remplir,174
2078,139,965,529,11,518,436,MN,2014,V,1,31,555,I,529,0,10,"Avec vous, toulouse avance !",A remplir,150
2079,141,957,569,8,561,388,MN,2014,V,1,31,555,I,569,0,10,"Avec vous, toulouse avance !",A remplir,151
2080,164,1183,491,16,475,692,MN,2014,V,1,31,555,I,491,0,10,"Avec vous, toulouse avance !",A remplir,191
2081,181,931,370,12,358,561,MN,2014,V,1,31,555,I,370,0,10,"Avec vous, toulouse avance !",A remplir,122
2082,211A,1286,623,28,595,663,MN,2014,V,1,31,555,I,623,0,10,"Avec vous, toulouse avance !",A remplir,187
2083,2,931,505,12,493,426,MN,2014,V,1,31,555,I,505,0,10,"Avec vous, toulouse avance !",A remplir,159
2084,9,941,528,3,525,413,MN,2014,V,1,31,555,I,528,0,10,"Avec vous, toulouse avance !",A remplir,164
2085,40,1276,595,11,584,681,MN,2014,V,1,31,555,I,595,0,10,"Avec vous, toulouse avance !",A remplir,226
2086,59,1038,581,10,571,457,MN,2014,V,1,31,555,I,581,0,10,"Avec vous, toulouse avance !",A remplir,206
2087,88,1122,596,12,584,526,MN,2014,V,1,31,555,I,596,0,10,"Avec vous, toulouse avance !",A remplir,201
2088,106,962,481,17,465,481,MN,2014,V,1,31,555,I,481,0,10,"Avec vous, toulouse avance !",A remplir,165
2089,120,1058,610,18,592,448,MN,2014,V,1,31,555,I,610,0,10,"Avec vous, toulouse avance !",A remplir,139
2090,145,1015,549,14,535,466,MN,2014,V,1,31,555,I,549,0,10,"Avec vous, toulouse avance !",A remplir,194
2091,149,1123,622,12,610,501,MN,2014,V,1,31,555,I,622,0,10,"Avec vous, toulouse avance !",A remplir,219
2092,201B,1032,580,19,561,452,MN,2014,V,1,31,555,I,580,0,10,"Avec vous, toulouse avance !",A remplir,132
2093,206,1087,549,20,529,538,MN,2014,V,1,31,555,I,549,0,10,"Avec vous, toulouse avance !",A remplir,191
2094,55,1082,614,14,600,468,MN,2014,V,1,31,555,I,614,0,10,"Avec vous, toulouse avance !",A remplir,212
2095,83,1176,712,10,702,464,MN,2014,V,1,31,555,I,712,0,10,"Avec vous, toulouse avance !",A remplir,230
2096,136,730,449,8,442,281,MN,2014,V,1,31,555,I,449,0,10,"Avec vous, toulouse avance !",A remplir,113
2097,158,1155,634,10,624,521,MN,2014,V,1,31,555,I,634,0,10,"Avec vous, toulouse avance !",A remplir,254
2098,162,1033,534,12,522,499,MN,2014,V,1,31,555,I,534,0,10,"Avec vous, toulouse avance !",A remplir,196
2099,170,819,446,8,438,373,MN,2014,V,1,31,555,I,446,0,10,"Avec vous, toulouse avance !",A remplir,148
2100,172,870,533,11,522,337,MN,2014,V,1,31,555,I,533,0,10,"Avec vous, toulouse avance !",A remplir,144
2101,222,1321,665,21,644,656,MN,2014,V,1,31,555,I,665,0,10,"Avec vous, toulouse avance !",A remplir,206
2102,7,928,450,9,441,478,MN,2014,V,1,31,555,I,450,0,10,"Avec vous, toulouse avance !",A remplir,146
2103,11,1115,633,14,620,482,MN,2014,V,1,31,555,I,633,0,10,"Avec vous, toulouse avance !",A remplir,158
2104,21,944,561,12,549,383,MN,2014,V,1,31,555,I,561,0,10,"Avec vous, toulouse avance !",A remplir,108
2105,53,1067,569,13,556,498,MN,2014,V,1,31,555,I,569,0,10,"Avec vous, toulouse avance !",A remplir,210
2106,122,1038,637,5,632,401,MN,2014,V,1,31,555,I,637,0,10,"Avec vous, toulouse avance !",A remplir,113
2107,124,1082,650,16,634,432,MN,2014,V,1,31,555,I,650,0,10,"Avec vous, toulouse avance !",A remplir,155
2108,129,990,483,16,467,507,MN,2014,V,1,31,555,I,483,0,10,"Avec vous, toulouse avance !",A remplir,160
2109,134,875,516,10,506,359,MN,2014,V,1,31,555,I,516,0,10,"Avec vous, toulouse avance !",A remplir,109
2110,135,1027,636,7,630,391,MN,2014,V,1,31,555,I,636,0,10,"Avec vous, toulouse avance !",A remplir,176
2111,175,995,320,11,309,675,MN,2014,V,1,31,555,I,320,0,10,"Avec vous, toulouse avance !",A remplir,109
2112,177,1084,439,24,415,645,MN,2014,V,1,31,555,I,439,0,10,"Avec vous, toulouse avance !",A remplir,145
2113,193,650,268,4,264,382,MN,2014,V,1,31,555,I,268,0,10,"Avec vous, toulouse avance !",A remplir,88
2114,199,503,252,4,248,251,MN,2014,V,1,31,555,I,252,0,10,"Avec vous, toulouse avance !",A remplir,62
2115,213,1101,583,17,566,518,MN,2014,V,1,31,555,I,583,0,10,"Avec vous, toulouse avance !",A remplir,150
2116,219,1138,614,10,604,524,MN,2014,V,1,31,555,I,614,0,10,"Avec vous, toulouse avance !",A remplir,201
2117,12,1116,608,12,596,508,MN,2014,V,1,31,555,I,608,0,10,"Avec vous, toulouse avance !",A remplir,179
2118,31,1020,561,8,553,459,MN,2014,V,1,31,555,I,561,0,10,"Avec vous, toulouse avance !",A remplir,115
2119,36,806,435,14,421,371,MN,2014,V,1,31,555,I,435,0,10,"Avec vous, toulouse avance !",A remplir,128
2120,46,986,558,11,547,428,MN,2014,V,1,31,555,I,558,0,10,"Avec vous, toulouse avance !",A remplir,214
2121,81,1177,499,16,483,678,MN,2014,V,1,31,555,I,499,0,10,"Avec vous, toulouse avance !",A remplir,185
2122,142,890,459,6,453,431,MN,2014,V,1,31,555,I,459,0,10,"Avec vous, toulouse avance !",A remplir,97
2123,152,944,355,14,341,589,MN,2014,V,1,31,555,I,355,0,10,"Avec vous, toulouse avance !",A remplir,120
2124,167,995,543,9,534,452,MN,2014,V,1,31,555,I,543,0,10,"Avec vous, toulouse avance !",A remplir,176
2125,190,1008,247,9,238,761,MN,2014,V,1,31,555,I,247,0,10,"Avec vous, toulouse avance !",A remplir,79
2126,225,838,451,16,435,387,MN,2014,V,1,31,555,I,451,0,10,"Avec vous, toulouse avance !",A remplir,140
2127,49,759,440,8,432,319,MN,2014,V,1,31,555,I,440,0,10,"Avec vous, toulouse avance !",A remplir,170
2128,50,977,533,16,517,444,MN,2014,V,1,31,555,I,533,0,10,"Avec vous, toulouse avance !",A remplir,180
2129,60,1164,611,25,586,553,MN,2014,V,1,31,555,I,611,0,10,"Avec vous, toulouse avance !",A remplir,216
2130,108A,939,523,13,510,416,MN,2014,V,1,31,555,I,523,0,10,"Avec vous, toulouse avance !",A remplir,211
2131,125,957,575,11,564,382,MN,2014,V,1,31,555,I,575,0,10,"Avec vous, toulouse avance !",A remplir,140
2132,182,794,435,10,425,359,MN,2014,V,1,31,555,I,435,0,10,"Avec vous, toulouse avance !",A remplir,120
2133,215,1373,629,18,611,744,MN,2014,V,1,31,555,I,629,0,10,"Avec vous, toulouse avance !",A remplir,202
2134,1,1100,541,10,532,559,MN,2014,V,1,31,555,I,541,0,10,"Avec vous, toulouse avance !",A remplir,166
2135,44,971,558,16,542,413,MN,2014,V,1,31,555,I,558,0,10,"Avec vous, toulouse avance !",A remplir,181
2136,49A,856,513,8,505,343,MN,2014,V,1,31,555,I,513,0,10,"Avec vous, toulouse avance !",A remplir,156
2137,165A,982,609,11,598,373,MN,2014,V,1,31,555,I,609,0,10,"Avec vous, toulouse avance !",A remplir,195
2138,200,1192,654,15,639,538,MN,2014,V,1,31,555,I,654,0,10,"Avec vous, toulouse avance !",A remplir,122
2139,5,772,439,10,429,333,MN,2014,V,1,31,555,I,439,0,10,"Avec vous, toulouse avance !",A remplir,115
2140,24,1061,543,8,535,518,MN,2014,V,1,31,555,I,543,0,10,"Avec vous, toulouse avance !",A remplir,201
2141,25A,1002,518,11,507,484,MN,2014,V,1,31,555,I,518,0,10,"Avec vous, toulouse avance !",A remplir,191
2142,51,1230,659,18,641,571,MN,2014,V,1,31,555,I,659,0,10,"Avec vous, toulouse avance !",A remplir,237
2143,71,941,513,10,504,428,MN,2014,V,1,31,555,I,513,0,10,"Avec vous, toulouse avance !",A remplir,170
2144,78,1006,624,19,605,382,MN,2014,V,1,31,555,I,624,0,10,"Avec vous, toulouse avance !",A remplir,206
2145,79,915,498,6,491,417,MN,2014,V,1,31,555,I,498,0,10,"Avec vous, toulouse avance !",A remplir,194
2146,80,1173,553,9,544,620,MN,2014,V,1,31,555,I,553,0,10,"Avec vous, toulouse avance !",A remplir,184
2147,97,1084,564,10,553,520,MN,2014,V,1,31,555,I,564,0,10,"Avec vous, toulouse avance !",A remplir,216
2148,184,1151,355,10,345,796,MN,2014,V,1,31,555,I,355,0,10,"Avec vous, toulouse avance !",A remplir,120
2149,188,1220,497,20,477,723,MN,2014,V,1,31,555,I,497,0,10,"Avec vous, toulouse avance !",A remplir,179
2150,8,891,480,13,467,411,MN,2014,V,1,31,555,I,480,0,10,"Avec vous, toulouse avance !",A remplir,194
2151,14,1014,595,6,589,419,MN,2014,V,1,31,555,I,595,0,10,"Avec vous, toulouse avance !",A remplir,167
2152,34,953,496,10,486,457,MN,2014,V,1,31,555,I,496,0,10,"Avec vous, toulouse avance !",A remplir,180
2153,39,1160,603,12,591,557,MN,2014,V,1,31,555,I,603,0,10,"Avec vous, toulouse avance !",A remplir,231
2154,63,806,314,6,308,492,MN,2014,V,1,31,555,I,314,0,10,"Avec vous, toulouse avance !",A remplir,119
2155,124A,982,582,15,567,400,MN,2014,V,1,31,555,I,582,0,10,"Avec vous, toulouse avance !",A remplir,148
2156,205,1184,651,18,633,533,MN,2014,V,1,31,555,I,651,0,10,"Avec vous, toulouse avance !",A remplir,252
2157,6,1098,531,11,520,567,MN,2014,V,1,31,555,I,531,0,10,"Avec vous, toulouse avance !",A remplir,183
2158,23,1205,614,7,607,591,MN,2014,V,1,31,555,I,614,0,10,"Avec vous, toulouse avance !",A remplir,238
2159,64,1233,675,22,653,558,MN,2014,V,1,31,555,I,675,0,10,"Avec vous, toulouse avance !",A remplir,265
2160,75,949,456,15,441,493,MN,2014,V,1,31,555,I,456,0,10,"Avec vous, toulouse avance !",A remplir,207
2161,76,1007,517,7,510,490,MN,2014,V,1,31,555,I,517,0,10,"Avec vous, toulouse avance !",A remplir,185
2162,111,956,511,10,501,445,MN,2014,V,1,31,555,I,511,0,10,"Avec vous, toulouse avance !",A remplir,138
2163,123,1134,589,8,581,545,MN,2014,V,1,31,555,I,589,0,10,"Avec vous, toulouse avance !",A remplir,174
2164,131,1051,602,12,590,449,MN,2014,V,1,31,555,I,602,0,10,"Avec vous, toulouse avance !",A remplir,163
2165,154,809,278,13,265,531,MN,2014,V,1,31,555,I,278,0,10,"Avec vous, toulouse avance !",A remplir,98
2166,179,709,357,9,348,352,MN,2014,V,1,31,555,I,357,0,10,"Avec vous, toulouse avance !",A remplir,128
2167,211,1377,732,18,714,645,MN,2014,V,1,31,555,I,732,0,10,"Avec vous, toulouse avance !",A remplir,229
2168,13,1041,588,11,577,453,MN,2014,V,1,31,555,I,588,0,10,"Avec vous, toulouse avance !",A remplir,208
2169,15,1078,643,10,633,435,MN,2014,V,1,31,555,I,643,0,10,"Avec vous, toulouse avance !",A remplir,227
2170,27,1122,647,10,637,475,MN,2014,V,1,31,555,I,647,0,10,"Avec vous, toulouse avance !",A remplir,179
2171,36A,1124,605,14,591,519,MN,2014,V,1,31,555,I,605,0,10,"Avec vous, toulouse avance !",A remplir,216
2172,56A,894,469,9,460,425,MN,2014,V,1,31,555,I,469,0,10,"Avec vous, toulouse avance !",A remplir,161
2173,69,1090,574,12,562,516,MN,2014,V,1,31,555,I,574,0,10,"Avec vous, toulouse avance !",A remplir,202
2174,113,1030,455,18,437,575,MN,2014,V,1,31,555,I,455,0,10,"Avec vous, toulouse avance !",A remplir,165
2175,147,1006,591,11,580,415,MN,2014,V,1,31,555,I,591,0,10,"Avec vous, toulouse avance !",A remplir,223
2176,165,1463,797,24,773,666,MN,2014,V,1,31,555,I,797,0,10,"Avec vous, toulouse avance !",A remplir,353
2177,201A,1154,711,21,690,443,MN,2014,V,1,31,555,I,711,0,10,"Avec vous, toulouse avance !",A remplir,126
2178,204,1153,587,18,569,566,MN,2014,V,1,31,555,I,587,0,10,"Avec vous, toulouse avance !",A remplir,250
2179,218,1264,701,15,686,563,MN,2014,V,1,31,555,I,701,0,10,"Avec vous, toulouse avance !",A remplir,221
2180,220,1242,685,19,666,557,MN,2014,V,1,31,555,I,685,0,10,"Avec vous, toulouse avance !",A remplir,200
2181,42,962,516,14,502,446,MN,2014,V,1,31,555,I,516,0,10,"Avec vous, toulouse avance !",A remplir,140
2182,58,1199,536,13,523,663,MN,2014,V,1,31,555,I,536,0,10,"Avec vous, toulouse avance !",A remplir,200
2183,95,1039,530,11,519,509,MN,2014,V,1,31,555,I,530,0,10,"Avec vous, toulouse avance !",A remplir,171
2184,116,1060,541,13,528,519,MN,2014,V,1,31,555,I,541,0,10,"Avec vous, toulouse avance !",A remplir,177
2185,151,983,544,9,535,439,MN,2014,V,1,31,555,I,544,0,10,"Avec vous, toulouse avance !",A remplir,211
2186,155,726,257,7,250,469,MN,2014,V,1,31,555,I,257,0,10,"Avec vous, toulouse avance !",A remplir,105
2187,198B,1072,625,17,608,447,MN,2014,V,1,31,555,I,625,0,10,"Avec vous, toulouse avance !",A remplir,166
2188,201,1015,630,10,620,385,MN,2014,V,1,31,555,I,630,0,10,"Avec vous, toulouse avance !",A remplir,111
2189,224,780,412,11,401,368,MN,2014,V,1,31,555,I,412,0,10,"Avec vous, toulouse avance !",A remplir,135
2190,17,940,535,10,525,405,MN,2014,V,1,31,555,I,535,0,10,"Avec vous, toulouse avance !",A remplir,157
2191,65,1142,646,19,627,496,MN,2014,V,1,31,555,I,646,0,10,"Avec vous, toulouse avance !",A remplir,221
2192,67,983,550,21,529,433,MN,2014,V,1,31,555,I,550,0,10,"Avec vous, toulouse avance !",A remplir,202
2193,102,739,369,8,361,370,MN,2014,V,1,31,555,I,369,0,10,"Avec vous, toulouse avance !",A remplir,126
2194,113A,976,526,13,513,450,MN,2014,V,1,31,555,I,526,0,10,"Avec vous, toulouse avance !",A remplir,162
2195,119,970,576,9,567,394,MN,2014,V,1,31,555,I,576,0,10,"Avec vous, toulouse avance !",A remplir,104
2196,191A,925,327,20,307,598,MN,2014,V,1,31,555,I,327,0,10,"Avec vous, toulouse avance !",A remplir,99
2197,198,1241,700,19,681,541,MN,2014,V,1,31,555,I,700,0,10,"Avec vous, toulouse avance !",A remplir,189
2198,208,1196,696,27,669,500,MN,2014,V,1,31,555,I,696,0,10,"Avec vous, toulouse avance !",A remplir,236
2199,32,848,516,8,508,332,MN,2014,V,1,31,555,I,516,0,10,"Avec vous, toulouse avance !",A remplir,88
2200,33,1059,631,17,614,428,MN,2014,V,1,31,555,I,631,0,10,"Avec vous, toulouse avance !",A remplir,259
2201,44B,805,394,16,378,411,MN,2014,V,1,31,555,I,394,0,10,"Avec vous, toulouse avance !",A remplir,131
2202,54,991,513,15,497,478,MN,2014,V,1,31,555,I,513,0,10,"Avec vous, toulouse avance !",A remplir,179
2203,92,1184,581,19,562,603,MN,2014,V,1,31,555,I,581,0,10,"Avec vous, toulouse avance !",A remplir,193
2204,93,1248,671,22,649,577,MN,2014,V,1,31,555,I,671,0,10,"Avec vous, toulouse avance !",A remplir,238
2205,108,1029,598,16,582,431,MN,2014,V,1,31,555,I,598,0,10,"Avec vous, toulouse avance !",A remplir,162
2206,138,889,558,15,543,331,MN,2014,V,1,31,555,I,558,0,10,"Avec vous, toulouse avance !",A remplir,151
2207,153,706,148,5,143,558,MN,2014,V,1,31,555,I,148,0,10,"Avec vous, toulouse avance !",A remplir,57
2208,163,1016,466,7,460,550,MN,2014,V,1,31,555,I,466,0,10,"Avec vous, toulouse avance !",A remplir,188
2209,191,1000,255,12,243,745,MN,2014,V,1,31,555,I,255,0,10,"Avec vous, toulouse avance !",A remplir,91
2210,197,994,590,20,570,404,MN,2014,V,1,31,555,I,590,0,10,"Avec vous, toulouse avance !",A remplir,130
2211,198A,955,556,15,541,399,MN,2014,V,1,31,555,I,556,0,10,"Avec vous, toulouse avance !",A remplir,162
2212,223,1190,637,21,616,553,MN,2014,V,1,31,555,I,637,0,10,"Avec vous, toulouse avance !",A remplir,163
2213,226,987,505,6,499,482,MN,2014,V,1,31,555,I,505,0,10,"Avec vous, toulouse avance !",A remplir,153
2214,37,890,465,15,450,425,MN,2014,V,1,31,555,I,465,0,10,"Avec vous, toulouse avance !",A remplir,152
2215,70,1004,580,14,566,424,MN,2014,V,1,31,555,I,580,0,10,"Avec vous, toulouse avance !",A remplir,184
2216,74,1059,538,7,531,521,MN,2014,V,1,31,555,I,538,0,10,"Avec vous, toulouse avance !",A remplir,127
2217,178,970,371,10,361,599,MN,2014,V,1,31,555,I,371,0,10,"Avec vous, toulouse avance !",A remplir,131
2218,10A,1006,494,11,483,512,MN,2014,V,1,31,555,I,494,0,10,"Avec vous, toulouse avance !",A remplir,177
2219,29,1159,606,9,598,553,MN,2014,V,1,31,555,I,606,0,10,"Avec vous, toulouse avance !",A remplir,166
2220,67A,929,482,11,471,447,MN,2014,V,1,31,555,I,482,0,10,"Avec vous, toulouse avance !",A remplir,178
2221,100,1027,479,9,470,548,MN,2014,V,1,31,555,I,479,0,10,"Avec vous, toulouse avance !",A remplir,166
2222,114,1108,530,15,515,578,MN,2014,V,1,31,555,I,530,0,10,"Avec vous, toulouse avance !",A remplir,175
2223,126,911,511,9,502,400,MN,2014,V,1,31,555,I,511,0,10,"Avec vous, toulouse avance !",A remplir,158
2224,130,1083,574,13,561,509,MN,2014,V,1,31,555,I,574,0,10,"Avec vous, toulouse avance !",A remplir,183
2225,161,967,524,11,513,443,MN,2014,V,1,31,555,I,524,0,10,"Avec vous, toulouse avance !",A remplir,191
2226,174,1101,559,8,551,542,MN,2014,V,1,31,555,I,559,0,10,"Avec vous, toulouse avance !",A remplir,166
2227,202,1197,556,19,537,641,MN,2014,V,1,31,555,I,556,0,10,"Avec vous, toulouse avance !",A remplir,179
2228,216,1186,583,17,566,603,MN,2014,V,1,31,555,I,583,0,10,"Avec vous, toulouse avance !",A remplir,195
2229,216A,1122,459,20,439,663,MN,2014,V,1,31,555,I,459,0,10,"Avec vous, toulouse avance !",A remplir,127
2230,20,1041,656,16,640,385,MN,2014,V,1,31,555,I,656,0,10,"Avec vous, toulouse avance !",A remplir,163
2231,38,975,516,18,498,459,MN,2014,V,1,31,555,I,516,0,10,"Avec vous, toulouse avance !",A remplir,188
2232,43,1026,583,21,562,443,MN,2014,V,1,31,555,I,583,0,10,"Avec vous, toulouse avance !",A remplir,166
2233,133,983,556,15,541,427,MN,2014,V,1,31,555,I,556,0,10,"Avec vous, toulouse avance !",A remplir,181
2234,138A,951,606,17,589,345,MN,2014,V,1,31,555,I,606,0,10,"Avec vous, toulouse avance !",A remplir,186
2235,143,984,592,9,583,392,MN,2014,V,1,31,555,I,592,0,10,"Avec vous, toulouse avance !",A remplir,143
2236,160,1056,563,10,553,493,MN,2014,V,1,31,555,I,563,0,10,"Avec vous, toulouse avance !",A remplir,206
2237,180,755,275,2,273,480,MN,2014,V,1,31,555,I,275,0,10,"Avec vous, toulouse avance !",A remplir,101
2238,195B,1078,677,18,659,401,MN,2014,V,1,31,555,I,677,0,10,"Avec vous, toulouse avance !",A remplir,186
2239,196,1165,666,15,651,499,MN,2014,V,1,31,555,I,666,0,10,"Avec vous, toulouse avance !",A remplir,214
2240,217,1275,630,18,612,645,MN,2014,V,1,31,555,I,630,0,10,"Avec vous, toulouse avance !",A remplir,197
2241,28,1074,561,7,554,513,MN,2014,V,1,31,555,I,561,0,10,Toulouse bleu marine,A remplir,33
2242,41,975,548,11,537,427,MN,2014,V,1,31,555,I,548,0,10,Toulouse bleu marine,A remplir,44
2243,72,1046,510,5,505,536,MN,2014,V,1,31,555,I,510,0,10,Toulouse bleu marine,A remplir,26
2244,105,961,472,16,456,489,MN,2014,V,1,31,555,I,472,0,10,Toulouse bleu marine,A remplir,63
2245,109,1098,619,15,604,479,MN,2014,V,1,31,555,I,619,0,10,Toulouse bleu marine,A remplir,48
2246,117,1119,551,9,542,568,MN,2014,V,1,31,555,I,551,0,10,Toulouse bleu marine,A remplir,72
2247,121,1065,621,6,615,444,MN,2014,V,1,31,555,I,621,0,10,Toulouse bleu marine,A remplir,30
2248,171,1072,450,13,437,622,MN,2014,V,1,31,555,I,450,0,10,Toulouse bleu marine,A remplir,55
2249,174A,1093,484,9,475,609,MN,2014,V,1,31,555,I,484,0,10,Toulouse bleu marine,A remplir,63
2250,192,698,315,9,306,383,MN,2014,V,1,31,555,I,315,0,10,Toulouse bleu marine,A remplir,41
2251,194,863,405,15,390,458,MN,2014,V,1,31,555,I,405,0,10,Toulouse bleu marine,A remplir,35
2252,214,1312,659,16,643,653,MN,2014,V,1,31,555,I,659,0,10,Toulouse bleu marine,A remplir,78
2253,3,919,501,10,491,418,MN,2014,V,1,31,555,I,501,0,10,Toulouse bleu marine,A remplir,30
2254,44A,1061,529,19,510,532,MN,2014,V,1,31,555,I,529,0,10,Toulouse bleu marine,A remplir,37
2255,47,1034,588,11,577,446,MN,2014,V,1,31,555,I,588,0,10,Toulouse bleu marine,A remplir,44
2256,62,1049,498,12,486,551,MN,2014,V,1,31,555,I,498,0,10,Toulouse bleu marine,A remplir,48
2257,82,976,490,12,478,486,MN,2014,V,1,31,555,I,490,0,10,Toulouse bleu marine,A remplir,26
2258,86,1070,542,8,534,528,MN,2014,V,1,31,555,I,542,0,10,Toulouse bleu marine,A remplir,21
2259,127,908,537,9,528,371,MN,2014,V,1,31,555,I,537,0,10,Toulouse bleu marine,A remplir,35
2260,156,889,425,11,414,464,MN,2014,V,1,31,555,I,425,0,10,Toulouse bleu marine,A remplir,34
2261,159,1232,667,12,655,565,MN,2014,V,1,31,555,I,667,0,10,Toulouse bleu marine,A remplir,39
2262,169,953,362,11,351,591,MN,2014,V,1,31,555,I,362,0,10,Toulouse bleu marine,A remplir,58
2263,173,962,388,8,380,574,MN,2014,V,1,31,555,I,388,0,10,Toulouse bleu marine,A remplir,50
2264,203,848,421,16,405,427,MN,2014,V,1,31,555,I,421,0,10,Toulouse bleu marine,A remplir,47
2265,203B,1049,585,16,569,464,MN,2014,V,1,31,555,I,585,0,10,Toulouse bleu marine,A remplir,53
2266,18,1208,703,23,680,505,MN,2014,V,1,31,555,I,703,0,10,Toulouse bleu marine,A remplir,51
2267,48,1004,509,11,498,495,MN,2014,V,1,31,555,I,509,0,10,Toulouse bleu marine,A remplir,39
2268,57,882,517,18,499,365,MN,2014,V,1,31,555,I,517,0,10,Toulouse bleu marine,A remplir,32
2269,68,1002,582,23,559,420,MN,2014,V,1,31,555,I,582,0,10,Toulouse bleu marine,A remplir,54
2270,128,1114,576,22,554,538,MN,2014,V,1,31,555,I,576,0,10,Toulouse bleu marine,A remplir,36
2271,137,995,617,10,607,378,MN,2014,V,1,31,555,I,617,0,10,Toulouse bleu marine,A remplir,43
2272,144A,992,563,13,551,429,MN,2014,V,1,31,555,I,563,0,10,Toulouse bleu marine,A remplir,32
2273,157,1208,645,11,634,563,MN,2014,V,1,31,555,I,645,0,10,Toulouse bleu marine,A remplir,49
2274,166,1147,666,12,653,481,MN,2014,V,1,31,555,I,666,0,10,Toulouse bleu marine,A remplir,36
2275,195,811,443,7,436,368,MN,2014,V,1,31,555,I,443,0,10,Toulouse bleu marine,A remplir,66
2276,200A,1064,537,13,524,527,MN,2014,V,1,31,555,I,537,0,10,Toulouse bleu marine,A remplir,59
2277,203A,817,451,6,445,366,MN,2014,V,1,31,555,I,451,0,10,Toulouse bleu marine,A remplir,59
2278,35,1057,526,10,516,531,MN,2014,V,1,31,555,I,526,0,10,Toulouse bleu marine,A remplir,20
2279,45,1038,429,8,421,609,MN,2014,V,1,31,555,I,429,0,10,Toulouse bleu marine,A remplir,47
2280,61,859,467,16,451,392,MN,2014,V,1,31,555,I,467,0,10,Toulouse bleu marine,A remplir,36
2281,94,1110,641,11,630,469,MN,2014,V,1,31,555,I,641,0,10,Toulouse bleu marine,A remplir,32
2282,107,1019,581,8,573,438,MN,2014,V,1,31,555,I,581,0,10,Toulouse bleu marine,A remplir,53
2283,110,918,502,13,489,416,MN,2014,V,1,31,555,I,502,0,10,Toulouse bleu marine,A remplir,37
2284,134A,1406,745,22,723,661,MN,2014,V,1,31,555,I,745,0,10,Toulouse bleu marine,A remplir,55
2285,146,833,440,3,437,393,MN,2014,V,1,31,555,I,440,0,10,Toulouse bleu marine,A remplir,28
2286,186,1299,322,18,304,977,MN,2014,V,1,31,555,I,322,0,10,Toulouse bleu marine,A remplir,18
2287,195A,1090,474,13,461,616,MN,2014,V,1,31,555,I,474,0,10,Toulouse bleu marine,A remplir,66
2288,16,947,558,10,548,389,MN,2014,V,1,31,555,I,558,0,10,Toulouse bleu marine,A remplir,28
2289,39A,938,525,28,497,413,MN,2014,V,1,31,555,I,525,0,10,Toulouse bleu marine,A remplir,27
2290,85,994,452,13,439,542,MN,2014,V,1,31,555,I,452,0,10,Toulouse bleu marine,A remplir,18
2291,87,1204,619,8,612,585,MN,2014,V,1,31,555,I,619,0,10,Toulouse bleu marine,A remplir,59
2292,93B,1235,656,16,640,579,MN,2014,V,1,31,555,I,656,0,10,Toulouse bleu marine,A remplir,77
2293,101,1126,627,10,617,499,MN,2014,V,1,31,555,I,627,0,10,Toulouse bleu marine,A remplir,37
2294,104,1042,609,21,588,433,MN,2014,V,1,31,555,I,609,0,10,Toulouse bleu marine,A remplir,54
2295,112,841,429,10,419,412,MN,2014,V,1,31,555,I,429,0,10,Toulouse bleu marine,A remplir,57
2296,148,830,418,14,404,412,MN,2014,V,1,31,555,I,418,0,10,Toulouse bleu marine,A remplir,30
2297,207,1141,602,18,584,539,MN,2014,V,1,31,555,I,602,0,10,Toulouse bleu marine,A remplir,56
2298,210,1252,597,16,581,655,MN,2014,V,1,31,555,I,597,0,10,Toulouse bleu marine,A remplir,98
2299,10,979,521,13,508,458,MN,2014,V,1,31,555,I,521,0,10,Toulouse bleu marine,A remplir,27
2300,77,976,544,9,535,432,MN,2014,V,1,31,555,I,544,0,10,Toulouse bleu marine,A remplir,28
2301,91,1000,523,15,508,477,MN,2014,V,1,31,555,I,523,0,10,Toulouse bleu marine,A remplir,32
2302,132,1073,553,5,548,520,MN,2014,V,1,31,555,I,553,0,10,Toulouse bleu marine,A remplir,63
2303,189,832,311,8,303,521,MN,2014,V,1,31,555,I,311,0,10,Toulouse bleu marine,A remplir,18
2304,193A,795,360,9,351,435,MN,2014,V,1,31,555,I,360,0,10,Toulouse bleu marine,A remplir,52
2305,209,1102,507,22,485,595,MN,2014,V,1,31,555,I,507,0,10,Toulouse bleu marine,A remplir,60
2306,212,442,187,4,183,255,MN,2014,V,1,31,555,I,187,0,10,Toulouse bleu marine,A remplir,33
2307,4,956,571,10,561,385,MN,2014,V,1,31,555,I,571,0,10,Toulouse bleu marine,A remplir,44
2308,19,1084,637,8,631,447,MN,2014,V,1,31,555,I,637,0,10,Toulouse bleu marine,A remplir,37
2309,30,992,554,7,547,438,MN,2014,V,1,31,555,I,554,0,10,Toulouse bleu marine,A remplir,29
2310,56,1025,487,8,479,538,MN,2014,V,1,31,555,I,487,0,10,Toulouse bleu marine,A remplir,26
2311,84,1173,642,7,635,531,MN,2014,V,1,31,555,I,642,0,10,Toulouse bleu marine,A remplir,28
2312,93A,1276,661,14,647,615,MN,2014,V,1,31,555,I,661,0,10,Toulouse bleu marine,A remplir,49
2313,144,991,611,13,598,380,MN,2014,V,1,31,555,I,611,0,10,Toulouse bleu marine,A remplir,45
2314,22,1086,605,16,589,481,MN,2014,V,1,31,555,I,605,0,10,Toulouse bleu marine,A remplir,28
2315,25,1083,547,7,540,536,MN,2014,V,1,31,555,I,547,0,10,Toulouse bleu marine,A remplir,35
2316,73,1069,531,13,518,538,MN,2014,V,1,31,555,I,531,0,10,Toulouse bleu marine,A remplir,26
2317,99,933,486,11,475,447,MN,2014,V,1,31,555,I,486,0,10,Toulouse bleu marine,A remplir,31
2318,103,871,459,18,441,412,MN,2014,V,1,31,555,I,459,0,10,Toulouse bleu marine,A remplir,35
2319,140,935,559,9,550,376,MN,2014,V,1,31,555,I,559,0,10,Toulouse bleu marine,A remplir,36
2320,150,1022,574,6,568,448,MN,2014,V,1,31,555,I,574,0,10,Toulouse bleu marine,A remplir,47
2321,168,934,464,17,447,470,MN,2014,V,1,31,555,I,464,0,10,Toulouse bleu marine,A remplir,59
2322,22A,1047,587,16,571,460,MN,2014,V,1,31,555,I,587,0,10,Toulouse bleu marine,A remplir,31
2323,52,1066,539,12,527,527,MN,2014,V,1,31,555,I,539,0,10,Toulouse bleu marine,A remplir,60
2324,66,862,474,16,458,388,MN,2014,V,1,31,555,I,474,0,10,Toulouse bleu marine,A remplir,20
2325,96,978,542,17,525,436,MN,2014,V,1,31,555,I,542,0,10,Toulouse bleu marine,A remplir,49
2326,118,1142,631,12,619,511,MN,2014,V,1,31,555,I,631,0,10,Toulouse bleu marine,A remplir,30
2327,139,965,529,11,518,436,MN,2014,V,1,31,555,I,529,0,10,Toulouse bleu marine,A remplir,43
2328,141,957,569,8,561,388,MN,2014,V,1,31,555,I,569,0,10,Toulouse bleu marine,A remplir,30
2329,164,1183,491,16,475,692,MN,2014,V,1,31,555,I,491,0,10,Toulouse bleu marine,A remplir,29
2330,181,931,370,12,358,561,MN,2014,V,1,31,555,I,370,0,10,Toulouse bleu marine,A remplir,33
2331,211A,1286,623,28,595,663,MN,2014,V,1,31,555,I,623,0,10,Toulouse bleu marine,A remplir,77
2332,2,931,505,12,493,426,MN,2014,V,1,31,555,I,505,0,10,Toulouse bleu marine,A remplir,24
2333,9,941,528,3,525,413,MN,2014,V,1,31,555,I,528,0,10,Toulouse bleu marine,A remplir,29
2334,40,1276,595,11,584,681,MN,2014,V,1,31,555,I,595,0,10,Toulouse bleu marine,A remplir,41
2335,59,1038,581,10,571,457,MN,2014,V,1,31,555,I,581,0,10,Toulouse bleu marine,A remplir,38
2336,88,1122,596,12,584,526,MN,2014,V,1,31,555,I,596,0,10,Toulouse bleu marine,A remplir,55
2337,106,962,481,17,465,481,MN,2014,V,1,31,555,I,481,0,10,Toulouse bleu marine,A remplir,62
2338,120,1058,610,18,592,448,MN,2014,V,1,31,555,I,610,0,10,Toulouse bleu marine,A remplir,42
2339,145,1015,549,14,535,466,MN,2014,V,1,31,555,I,549,0,10,Toulouse bleu marine,A remplir,34
2340,149,1123,622,12,610,501,MN,2014,V,1,31,555,I,622,0,10,Toulouse bleu marine,A remplir,56
2341,201B,1032,580,19,561,452,MN,2014,V,1,31,555,I,580,0,10,Toulouse bleu marine,A remplir,49
2342,206,1087,549,20,529,538,MN,2014,V,1,31,555,I,549,0,10,Toulouse bleu marine,A remplir,51
2343,55,1082,614,14,600,468,MN,2014,V,1,31,555,I,614,0,10,Toulouse bleu marine,A remplir,36
2344,83,1176,712,10,702,464,MN,2014,V,1,31,555,I,712,0,10,Toulouse bleu marine,A remplir,45
2345,136,730,449,8,442,281,MN,2014,V,1,31,555,I,449,0,10,Toulouse bleu marine,A remplir,21
2346,158,1155,634,10,624,521,MN,2014,V,1,31,555,I,634,0,10,Toulouse bleu marine,A remplir,39
2347,162,1033,534,12,522,499,MN,2014,V,1,31,555,I,534,0,10,Toulouse bleu marine,A remplir,30
2348,170,819,446,8,438,373,MN,2014,V,1,31,555,I,446,0,10,Toulouse bleu marine,A remplir,48
2349,172,870,533,11,522,337,MN,2014,V,1,31,555,I,533,0,10,Toulouse bleu marine,A remplir,43
2350,222,1321,665,21,644,656,MN,2014,V,1,31,555,I,665,0,10,Toulouse bleu marine,A remplir,71
2351,7,928,450,9,441,478,MN,2014,V,1,31,555,I,450,0,10,Toulouse bleu marine,A remplir,20
2352,11,1115,633,14,620,482,MN,2014,V,1,31,555,I,633,0,10,Toulouse bleu marine,A remplir,41
2353,21,944,561,12,549,383,MN,2014,V,1,31,555,I,561,0,10,Toulouse bleu marine,A remplir,32
2354,53,1067,569,13,556,498,MN,2014,V,1,31,555,I,569,0,10,Toulouse bleu marine,A remplir,37
2355,122,1038,637,5,632,401,MN,2014,V,1,31,555,I,637,0,10,Toulouse bleu marine,A remplir,40
2356,124,1082,650,16,634,432,MN,2014,V,1,31,555,I,650,0,10,Toulouse bleu marine,A remplir,43
2357,129,990,483,16,467,507,MN,2014,V,1,31,555,I,483,0,10,Toulouse bleu marine,A remplir,46
2358,134,875,516,10,506,359,MN,2014,V,1,31,555,I,516,0,10,Toulouse bleu marine,A remplir,36
2359,135,1027,636,7,630,391,MN,2014,V,1,31,555,I,636,0,10,Toulouse bleu marine,A remplir,37
2360,175,995,320,11,309,675,MN,2014,V,1,31,555,I,320,0,10,Toulouse bleu marine,A remplir,25
2361,177,1084,439,24,415,645,MN,2014,V,1,31,555,I,439,0,10,Toulouse bleu marine,A remplir,28
2362,193,650,268,4,264,382,MN,2014,V,1,31,555,I,268,0,10,Toulouse bleu marine,A remplir,30
2363,199,503,252,4,248,251,MN,2014,V,1,31,555,I,252,0,10,Toulouse bleu marine,A remplir,37
2364,213,1101,583,17,566,518,MN,2014,V,1,31,555,I,583,0,10,Toulouse bleu marine,A remplir,66
2365,219,1138,614,10,604,524,MN,2014,V,1,31,555,I,614,0,10,Toulouse bleu marine,A remplir,66
2366,12,1116,608,12,596,508,MN,2014,V,1,31,555,I,608,0,10,Toulouse bleu marine,A remplir,70
2367,31,1020,561,8,553,459,MN,2014,V,1,31,555,I,561,0,10,Toulouse bleu marine,A remplir,24
2368,36,806,435,14,421,371,MN,2014,V,1,31,555,I,435,0,10,Toulouse bleu marine,A remplir,25
2369,46,986,558,11,547,428,MN,2014,V,1,31,555,I,558,0,10,Toulouse bleu marine,A remplir,43
2370,81,1177,499,16,483,678,MN,2014,V,1,31,555,I,499,0,10,Toulouse bleu marine,A remplir,39
2371,142,890,459,6,453,431,MN,2014,V,1,31,555,I,459,0,10,Toulouse bleu marine,A remplir,93
2372,152,944,355,14,341,589,MN,2014,V,1,31,555,I,355,0,10,Toulouse bleu marine,A remplir,44
2373,167,995,543,9,534,452,MN,2014,V,1,31,555,I,543,0,10,Toulouse bleu marine,A remplir,33
2374,190,1008,247,9,238,761,MN,2014,V,1,31,555,I,247,0,10,Toulouse bleu marine,A remplir,15
2375,225,838,451,16,435,387,MN,2014,V,1,31,555,I,451,0,10,Toulouse bleu marine,A remplir,61
2376,49,759,440,8,432,319,MN,2014,V,1,31,555,I,440,0,10,Toulouse bleu marine,A remplir,38
2377,50,977,533,16,517,444,MN,2014,V,1,31,555,I,533,0,10,Toulouse bleu marine,A remplir,42
2378,60,1164,611,25,586,553,MN,2014,V,1,31,555,I,611,0,10,Toulouse bleu marine,A remplir,55
2379,108A,939,523,13,510,416,MN,2014,V,1,31,555,I,523,0,10,Toulouse bleu marine,A remplir,53
2380,125,957,575,11,564,382,MN,2014,V,1,31,555,I,575,0,10,Toulouse bleu marine,A remplir,27
2381,182,794,435,10,425,359,MN,2014,V,1,31,555,I,435,0,10,Toulouse bleu marine,A remplir,44
2382,215,1373,629,18,611,744,MN,2014,V,1,31,555,I,629,0,10,Toulouse bleu marine,A remplir,48
2383,1,1100,541,10,532,559,MN,2014,V,1,31,555,I,541,0,10,Toulouse bleu marine,A remplir,40
2384,44,971,558,16,542,413,MN,2014,V,1,31,555,I,558,0,10,Toulouse bleu marine,A remplir,30
2385,49A,856,513,8,505,343,MN,2014,V,1,31,555,I,513,0,10,Toulouse bleu marine,A remplir,44
2386,165A,982,609,11,598,373,MN,2014,V,1,31,555,I,609,0,10,Toulouse bleu marine,A remplir,43
2387,200,1192,654,15,639,538,MN,2014,V,1,31,555,I,654,0,10,Toulouse bleu marine,A remplir,68
2388,5,772,439,10,429,333,MN,2014,V,1,31,555,I,439,0,10,Toulouse bleu marine,A remplir,33
2389,24,1061,543,8,535,518,MN,2014,V,1,31,555,I,543,0,10,Toulouse bleu marine,A remplir,17
2390,25A,1002,518,11,507,484,MN,2014,V,1,31,555,I,518,0,10,Toulouse bleu marine,A remplir,27
2391,51,1230,659,18,641,571,MN,2014,V,1,31,555,I,659,0,10,Toulouse bleu marine,A remplir,39
2392,71,941,513,10,504,428,MN,2014,V,1,31,555,I,513,0,10,Toulouse bleu marine,A remplir,53
2393,78,1006,624,19,605,382,MN,2014,V,1,31,555,I,624,0,10,Toulouse bleu marine,A remplir,34
2394,79,915,498,6,491,417,MN,2014,V,1,31,555,I,498,0,10,Toulouse bleu marine,A remplir,20
2395,80,1173,553,9,544,620,MN,2014,V,1,31,555,I,553,0,10,Toulouse bleu marine,A remplir,40
2396,97,1084,564,10,553,520,MN,2014,V,1,31,555,I,564,0,10,Toulouse bleu marine,A remplir,59
2397,184,1151,355,10,345,796,MN,2014,V,1,31,555,I,355,0,10,Toulouse bleu marine,A remplir,23
2398,188,1220,497,20,477,723,MN,2014,V,1,31,555,I,497,0,10,Toulouse bleu marine,A remplir,52
2399,8,891,480,13,467,411,MN,2014,V,1,31,555,I,480,0,10,Toulouse bleu marine,A remplir,20
2400,14,1014,595,6,589,419,MN,2014,V,1,31,555,I,595,0,10,Toulouse bleu marine,A remplir,39
2401,34,953,496,10,486,457,MN,2014,V,1,31,555,I,496,0,10,Toulouse bleu marine,A remplir,34
2402,39,1160,603,12,591,557,MN,2014,V,1,31,555,I,603,0,10,Toulouse bleu marine,A remplir,23
2403,63,806,314,6,308,492,MN,2014,V,1,31,555,I,314,0,10,Toulouse bleu marine,A remplir,38
2404,124A,982,582,15,567,400,MN,2014,V,1,31,555,I,582,0,10,Toulouse bleu marine,A remplir,26
2405,205,1184,651,18,633,533,MN,2014,V,1,31,555,I,651,0,10,Toulouse bleu marine,A remplir,82
2406,6,1098,531,11,520,567,MN,2014,V,1,31,555,I,531,0,10,Toulouse bleu marine,A remplir,14
2407,23,1205,614,7,607,591,MN,2014,V,1,31,555,I,614,0,10,Toulouse bleu marine,A remplir,39
2408,64,1233,675,22,653,558,MN,2014,V,1,31,555,I,675,0,10,Toulouse bleu marine,A remplir,63
2409,75,949,456,15,441,493,MN,2014,V,1,31,555,I,456,0,10,Toulouse bleu marine,A remplir,20
2410,76,1007,517,7,510,490,MN,2014,V,1,31,555,I,517,0,10,Toulouse bleu marine,A remplir,22
2411,111,956,511,10,501,445,MN,2014,V,1,31,555,I,511,0,10,Toulouse bleu marine,A remplir,51
2412,123,1134,589,8,581,545,MN,2014,V,1,31,555,I,589,0,10,Toulouse bleu marine,A remplir,46
2413,131,1051,602,12,590,449,MN,2014,V,1,31,555,I,602,0,10,Toulouse bleu marine,A remplir,45
2414,154,809,278,13,265,531,MN,2014,V,1,31,555,I,278,0,10,Toulouse bleu marine,A remplir,38
2415,179,709,357,9,348,352,MN,2014,V,1,31,555,I,357,0,10,Toulouse bleu marine,A remplir,37
2416,211,1377,732,18,714,645,MN,2014,V,1,31,555,I,732,0,10,Toulouse bleu marine,A remplir,99
2417,13,1041,588,11,577,453,MN,2014,V,1,31,555,I,588,0,10,Toulouse bleu marine,A remplir,37
2418,15,1078,643,10,633,435,MN,2014,V,1,31,555,I,643,0,10,Toulouse bleu marine,A remplir,32
2419,27,1122,647,10,637,475,MN,2014,V,1,31,555,I,647,0,10,Toulouse bleu marine,A remplir,25
2420,36A,1124,605,14,591,519,MN,2014,V,1,31,555,I,605,0,10,Toulouse bleu marine,A remplir,19
2421,56A,894,469,9,460,425,MN,2014,V,1,31,555,I,469,0,10,Toulouse bleu marine,A remplir,25
2422,69,1090,574,12,562,516,MN,2014,V,1,31,555,I,574,0,10,Toulouse bleu marine,A remplir,47
2423,113,1030,455,18,437,575,MN,2014,V,1,31,555,I,455,0,10,Toulouse bleu marine,A remplir,44
2424,147,1006,591,11,580,415,MN,2014,V,1,31,555,I,591,0,10,Toulouse bleu marine,A remplir,46
2425,165,1463,797,24,773,666,MN,2014,V,1,31,555,I,797,0,10,Toulouse bleu marine,A remplir,36
2426,201A,1154,711,21,690,443,MN,2014,V,1,31,555,I,711,0,10,Toulouse bleu marine,A remplir,43
2427,204,1153,587,18,569,566,MN,2014,V,1,31,555,I,587,0,10,Toulouse bleu marine,A remplir,56
2428,218,1264,701,15,686,563,MN,2014,V,1,31,555,I,701,0,10,Toulouse bleu marine,A remplir,96
2429,220,1242,685,19,666,557,MN,2014,V,1,31,555,I,685,0,10,Toulouse bleu marine,A remplir,69
2430,42,962,516,14,502,446,MN,2014,V,1,31,555,I,516,0,10,Toulouse bleu marine,A remplir,33
2431,58,1199,536,13,523,663,MN,2014,V,1,31,555,I,536,0,10,Toulouse bleu marine,A remplir,40
2432,95,1039,530,11,519,509,MN,2014,V,1,31,555,I,530,0,10,Toulouse bleu marine,A remplir,43
2433,116,1060,541,13,528,519,MN,2014,V,1,31,555,I,541,0,10,Toulouse bleu marine,A remplir,53
2434,151,983,544,9,535,439,MN,2014,V,1,31,555,I,544,0,10,Toulouse bleu marine,A remplir,42
2435,155,726,257,7,250,469,MN,2014,V,1,31,555,I,257,0,10,Toulouse bleu marine,A remplir,23
2436,198B,1072,625,17,608,447,MN,2014,V,1,31,555,I,625,0,10,Toulouse bleu marine,A remplir,62
2437,201,1015,630,10,620,385,MN,2014,V,1,31,555,I,630,0,10,Toulouse bleu marine,A remplir,46
2438,224,780,412,11,401,368,MN,2014,V,1,31,555,I,412,0,10,Toulouse bleu marine,A remplir,41
2439,17,940,535,10,525,405,MN,2014,V,1,31,555,I,535,0,10,Toulouse bleu marine,A remplir,35
2440,65,1142,646,19,627,496,MN,2014,V,1,31,555,I,646,0,10,Toulouse bleu marine,A remplir,56
2441,67,983,550,21,529,433,MN,2014,V,1,31,555,I,550,0,10,Toulouse bleu marine,A remplir,23
2442,102,739,369,8,361,370,MN,2014,V,1,31,555,I,369,0,10,Toulouse bleu marine,A remplir,23
2443,113A,976,526,13,513,450,MN,2014,V,1,31,555,I,526,0,10,Toulouse bleu marine,A remplir,67
2444,119,970,576,9,567,394,MN,2014,V,1,31,555,I,576,0,10,Toulouse bleu marine,A remplir,38
2445,191A,925,327,20,307,598,MN,2014,V,1,31,555,I,327,0,10,Toulouse bleu marine,A remplir,29
2446,198,1241,700,19,681,541,MN,2014,V,1,31,555,I,700,0,10,Toulouse bleu marine,A remplir,87
2447,208,1196,696,27,669,500,MN,2014,V,1,31,555,I,696,0,10,Toulouse bleu marine,A remplir,72
2448,32,848,516,8,508,332,MN,2014,V,1,31,555,I,516,0,10,Toulouse bleu marine,A remplir,32
2449,33,1059,631,17,614,428,MN,2014,V,1,31,555,I,631,0,10,Toulouse bleu marine,A remplir,40
2450,44B,805,394,16,378,411,MN,2014,V,1,31,555,I,394,0,10,Toulouse bleu marine,A remplir,40
2451,54,991,513,15,497,478,MN,2014,V,1,31,555,I,513,0,10,Toulouse bleu marine,A remplir,37
2452,92,1184,581,19,562,603,MN,2014,V,1,31,555,I,581,0,10,Toulouse bleu marine,A remplir,43
2453,93,1248,671,22,649,577,MN,2014,V,1,31,555,I,671,0,10,Toulouse bleu marine,A remplir,34
2454,108,1029,598,16,582,431,MN,2014,V,1,31,555,I,598,0,10,Toulouse bleu marine,A remplir,60
2455,138,889,558,15,543,331,MN,2014,V,1,31,555,I,558,0,10,Toulouse bleu marine,A remplir,27
2456,153,706,148,5,143,558,MN,2014,V,1,31,555,I,148,0,10,Toulouse bleu marine,A remplir,11
2457,163,1016,466,7,460,550,MN,2014,V,1,31,555,I,466,0,10,Toulouse bleu marine,A remplir,35
2458,191,1000,255,12,243,745,MN,2014,V,1,31,555,I,255,0,10,Toulouse bleu marine,A remplir,6
2459,197,994,590,20,570,404,MN,2014,V,1,31,555,I,590,0,10,Toulouse bleu marine,A remplir,54
2460,198A,955,556,15,541,399,MN,2014,V,1,31,555,I,556,0,10,Toulouse bleu marine,A remplir,45
2461,223,1190,637,21,616,553,MN,2014,V,1,31,555,I,637,0,10,Toulouse bleu marine,A remplir,89
2462,226,987,505,6,499,482,MN,2014,V,1,31,555,I,505,0,10,Toulouse bleu marine,A remplir,69
2463,37,890,465,15,450,425,MN,2014,V,1,31,555,I,465,0,10,Toulouse bleu marine,A remplir,35
2464,70,1004,580,14,566,424,MN,2014,V,1,31,555,I,580,0,10,Toulouse bleu marine,A remplir,38
2465,74,1059,538,7,531,521,MN,2014,V,1,31,555,I,538,0,10,Toulouse bleu marine,A remplir,36
2466,178,970,371,10,361,599,MN,2014,V,1,31,555,I,371,0,10,Toulouse bleu marine,A remplir,36
2467,10A,1006,494,11,483,512,MN,2014,V,1,31,555,I,494,0,10,Toulouse bleu marine,A remplir,27
2468,29,1159,606,9,598,553,MN,2014,V,1,31,555,I,606,0,10,Toulouse bleu marine,A remplir,28
2469,67A,929,482,11,471,447,MN,2014,V,1,31,555,I,482,0,10,Toulouse bleu marine,A remplir,24
2470,100,1027,479,9,470,548,MN,2014,V,1,31,555,I,479,0,10,Toulouse bleu marine,A remplir,24
2471,114,1108,530,15,515,578,MN,2014,V,1,31,555,I,530,0,10,Toulouse bleu marine,A remplir,65
2472,126,911,511,9,502,400,MN,2014,V,1,31,555,I,511,0,10,Toulouse bleu marine,A remplir,30
2473,130,1083,574,13,561,509,MN,2014,V,1,31,555,I,574,0,10,Toulouse bleu marine,A remplir,48
2474,161,967,524,11,513,443,MN,2014,V,1,31,555,I,524,0,10,Toulouse bleu marine,A remplir,28
2475,174,1101,559,8,551,542,MN,2014,V,1,31,555,I,559,0,10,Toulouse bleu marine,A remplir,68
2476,202,1197,556,19,537,641,MN,2014,V,1,31,555,I,556,0,10,Toulouse bleu marine,A remplir,70
2477,216,1186,583,17,566,603,MN,2014,V,1,31,555,I,583,0,10,Toulouse bleu marine,A remplir,55
2478,216A,1122,459,20,439,663,MN,2014,V,1,31,555,I,459,0,10,Toulouse bleu marine,A remplir,59
2479,20,1041,656,16,640,385,MN,2014,V,1,31,555,I,656,0,10,Toulouse bleu marine,A remplir,31
2480,38,975,516,18,498,459,MN,2014,V,1,31,555,I,516,0,10,Toulouse bleu marine,A remplir,50
2481,43,1026,583,21,562,443,MN,2014,V,1,31,555,I,583,0,10,Toulouse bleu marine,A remplir,48
2482,133,983,556,15,541,427,MN,2014,V,1,31,555,I,556,0,10,Toulouse bleu marine,A remplir,54
2483,138A,951,606,17,589,345,MN,2014,V,1,31,555,I,606,0,10,Toulouse bleu marine,A remplir,41
2484,143,984,592,9,583,392,MN,2014,V,1,31,555,I,592,0,10,Toulouse bleu marine,A remplir,51
2485,160,1056,563,10,553,493,MN,2014,V,1,31,555,I,563,0,10,Toulouse bleu marine,A remplir,32
2486,180,755,275,2,273,480,MN,2014,V,1,31,555,I,275,0,10,Toulouse bleu marine,A remplir,19
2487,195B,1078,677,18,659,401,MN,2014,V,1,31,555,I,677,0,10,Toulouse bleu marine,A remplir,52
2488,196,1165,666,15,651,499,MN,2014,V,1,31,555,I,666,0,10,Toulouse bleu marine,A remplir,63
2489,217,1275,630,18,612,645,MN,2014,V,1,31,555,I,630,0,10,Toulouse bleu marine,A remplir,73
